惱巴巴	ㄋㄠˇ　ㄅㄚ　ㄅㄚ
西泠八家	ㄒ｜　ㄌ｜ㄥˊ　ㄅㄚ　ㄐ｜ㄚ
八字鬍	ㄅㄚ　ㄗˋ　ㄏㄨˊ
把式	ㄅㄚˇ　˙ㄕ
把弄	ㄅㄚˇ　ㄋㄨㄥˋ
芭棚	ㄅㄚ　ㄆㄥˊ
七了八當	ㄑ｜　ㄌ｜ㄠˇ　ㄅㄚ　ㄉㄤˋ
拔地搖山	ㄅㄚˊ　ㄉ｜ˋ　｜ㄠˊ　ㄕㄢ
把鼻	ㄅㄚˇ　ㄅ｜ˊ
笆籬子	ㄅㄚ　ㄌ｜ˊ　˙ㄗ
帕巴拉	ㄆㄚˋ　ㄅㄚ　ㄌㄚ
巴想	ㄅㄚ　ㄒ｜ㄤˇ
罷閒	ㄅㄚˋ　ㄒ｜ㄢˊ
大把	ㄉㄚˋ　ㄅㄚˇ
狗長尾巴尖兒	ㄍㄡˇ　ㄓㄤˇ　ㄨㄟˇ　˙ㄅㄚ　ㄐ｜ㄢㄦ　(變)ㄍㄡˇ　ㄓㄤˇ　ㄨㄟˇ　˙ㄅㄚ　ㄐ｜ㄚㄦ
拔類超群	ㄅㄚˊ　ㄌㄟˋ　ㄔㄠ　ㄑㄩㄣˊ
打靶	ㄉㄚˇ　ㄅㄚˇ
八駿馬	ㄅㄚ　ㄐㄩㄣˋ　ㄇㄚˇ
拔錨	ㄅㄚˊ　ㄇㄠˊ
把齋	ㄅㄚˇ　ㄓㄞ
老八股	ㄌㄠˇ　ㄅㄚ　ㄍㄨˇ
腰把子	｜ㄠ　ㄅㄚˇ　˙ㄗ
作罷	ㄗㄨㄛˋ　ㄅㄚˋ
嘴巴	ㄗㄨㄟˇ　˙ㄅㄚ
拔爾波亞	ㄅㄚˊ　ㄦˇ　ㄅㄛ　｜ㄚˋ
八更	ㄅㄚ　ㄍㄥ
八書	ㄅㄚ　ㄕㄨ
八字還沒一撇兒	ㄅㄚ　ㄗˋ　ㄏㄞˊ　ㄇㄟˊ　｜　ㄆ｜ㄝˇㄦ　(變)ㄅㄚˊ　ㄗˋ　ㄏㄞˊ　ㄇㄟˊ　｜ˋ　ㄆ｜ㄜˇㄦ
把關	ㄅㄚˇ　ㄍㄨㄢ
出類拔群	ㄔㄨ　ㄌㄟˋ　ㄅㄚˊ　ㄑㄩㄣˊ
拔群出類	ㄅㄚˊ　ㄑㄩㄣˊ　ㄔㄨ　ㄌㄟˋ
七嘴八舌	ㄑ｜　ㄗㄨㄟˇ　ㄅㄚ　ㄕㄜˊ
第八藝術	ㄉ｜ˋ　ㄅㄚ　｜ˋ　ㄕㄨˋ
拔取	ㄅㄚˊ　ㄑㄩˇ
堅毅不拔	ㄐ｜ㄢ　｜ˋ　ㄅㄨˋ　ㄅㄚˊ
矲矮	ㄅㄚˋ　ㄞˇ
拔山扛鼎	ㄅㄚˊ　ㄕㄢ　ㄍㄤ　ㄉ｜ㄥˇ
巴貝基分析儀	ㄅㄚ　ㄅㄟˋ　ㄐ｜　ㄈㄣ　ㄒ｜　｜ˊ
十八羅漢	ㄕˊ　ㄅㄚ　ㄌㄨㄛˊ　ㄏㄢˋ
三八節	ㄙㄢ　ㄅㄚ　ㄐ｜ㄝˊ
八角金盤	ㄅㄚ　ㄐ｜ㄠˇ　ㄐ｜ㄣ　ㄆㄢˊ
甄拔	ㄓㄣ　ㄅㄚˊ
八音琴	ㄅㄚ　｜ㄣ　ㄑ｜ㄣˊ
拔脯兒	ㄅㄚˊ　ㄆㄨˊㄦ
喇叭筒	ㄌㄚˇ　˙ㄅㄚ　ㄊㄨㄥˇ
巴貝基	ㄅㄚ　ㄅㄟˋ　ㄐ｜
豬八戒照鏡子	ㄓㄨ　ㄅㄚ　ㄐ｜ㄝˋ　ㄓㄠˋ　ㄐ｜ㄥˋ　˙ㄗ
巴西高原	ㄅㄚ　ㄒ｜　ㄍㄠ　ㄩㄢˊ
火把	ㄏㄨㄛˇ　ㄅㄚˇ
八號分機	ㄅㄚ　ㄏㄠˋ　ㄈㄣ　ㄐ｜
大八丈	ㄉㄚˋ　ㄅㄚ　ㄓㄤˋ
拔山蓋世	ㄅㄚˊ　ㄕㄢ　ㄍㄞˋ　ㄕˋ
巴噠著嘴	ㄅㄚ　ㄉㄚˊ　˙ㄓㄜ　ㄗㄨㄟˇ
八都魯	ㄅㄚ　ㄉㄨ　ㄌㄨˇ
巴臂	ㄅㄚ　ㄅ｜ˋ
把總	ㄅㄚˇ　ㄗㄨㄥˇ
豬八戒上陣	ㄓㄨ　ㄅㄚ　ㄐ｜ㄝˋ　ㄕㄤˋ　ㄓㄣˋ
拔牙	ㄅㄚˊ　｜ㄚˊ
芭	ㄅㄚ
拔剌	ㄅㄚˊ　ㄌㄚˋ
打把勢	ㄉㄚˇ　ㄅㄚˇ　˙ㄕ
淋巴系統	ㄌ｜ㄣˊ　ㄅㄚ　ㄒ｜ˋ　ㄊㄨㄥˇ
拔十失五	ㄅㄚˊ　ㄕˊ　ㄕ　ㄨˇ
割尾巴	ㄍㄜ　ㄨㄟˇ　ㄅㄚ
把定了心	ㄅㄚˇ　ㄉ｜ㄥˋ　˙ㄌㄜ　ㄒ｜ㄣ
停罷	ㄊ｜ㄥˊ　ㄅㄚˋ
馬八六	ㄇㄚˇ　ㄅㄚ　ㄌ｜ㄡˋ
啞巴	｜ㄚˇ　˙ㄅㄚ
八柱	ㄅㄚ　ㄓㄨˋ
把臉一板	ㄅㄚˇ　ㄌ｜ㄢˇ　｜　ㄅㄢˇ
八公山	ㄅㄚ　ㄍㄨㄥ　ㄕㄢ
努筋拔力	ㄋㄨˇ　ㄐ｜ㄣ　ㄅㄚˊ　ㄌ｜ˋ
一朝權在手，便把令來行	｜　ㄓㄠ　ㄑㄩㄢˊ　ㄗㄞˋ　ㄕㄡˇ　ㄅ｜ㄢˋ　ㄅㄚˇ　ㄌ｜ㄥˋ　ㄌㄞˊ　ㄒ｜ㄥˊ
安地卡及巴布達	ㄢ　ㄉ｜ˋ　ㄎㄚˇ　ㄐ｜ˊ　ㄅㄚ　ㄅㄨˋ　ㄉㄚˊ
劣把頭	ㄌ｜ㄝˋ　˙ㄅㄚ　ㄊㄡˊ
八斗子	ㄅㄚ　ㄉㄡˇ　ㄗˇ
壩工	ㄅㄚˋ　ㄍㄨㄥ
矲雉	ㄅㄚˋ　ㄓˋ
把麼	ㄅㄚˇ　˙ㄇㄜ
八蜡	ㄅㄚ　ㄓㄚˋ
窟裡拔蛇	ㄎㄨ　ㄌ｜ˇ　ㄅㄚˊ　ㄕㄜˊ
把麻	ㄅㄚˇ　ㄇㄚˊ
丁八	ㄉ｜ㄥ　ㄅㄚ
拔樹撼山	ㄅㄚˊ　ㄕㄨˋ　ㄏㄢˋ　ㄕㄢ
豬八戒吃人參果	ㄓㄨ　ㄅㄚ　ㄐ｜ㄝˋ　ㄔ　ㄖㄣˊ　ㄕㄣ　ㄍㄨㄛˇ
十八相送	ㄕˊ　ㄅㄚ　ㄒ｜ㄤ　ㄙㄨㄥˋ
二八	ㄦˋ　ㄅㄚ
八材	ㄅㄚ　ㄘㄞˊ
巴比特合金	ㄅㄚ　ㄅ｜ˇ　ㄊㄜˋ　ㄏㄜˊ　ㄐ｜ㄣ
巴氏反射	ㄅㄚ　ㄕˋ　ㄈㄢˇ　ㄕㄜˋ
神仙一把抓	ㄕㄣˊ　ㄒ｜ㄢ　｜　ㄅㄚˇ　ㄓㄨㄚ
巴黎聖母院	ㄅㄚ　ㄌ｜ˊ　ㄕㄥˋ　ㄇㄨˇ　ㄩㄢˋ
梅香拜把子	ㄇㄟˊ　ㄒ｜ㄤ　ㄅㄞˋ　ㄅㄚˇ　˙ㄗ
留尾巴	ㄌ｜ㄡˊ　ㄨㄟˇ　˙ㄅㄚ
韓國八角會	ㄏㄢˊ　ㄍㄨㄛˊ　ㄅㄚ　ㄐ｜ㄠˇ　ㄏㄨㄟˋ
八拜之交	ㄅㄚ　ㄅㄞˋ　ㄓ　ㄐ｜ㄠ
加巴拉	ㄐ｜ㄚ　ㄅㄚ　ㄌㄚ
一二八事變	｜　ㄦˋ　ㄅㄚ　ㄕˋ　ㄅ｜ㄢˋ
千里達及托巴哥共和國	ㄑ｜ㄢ　ㄌ｜ˇ　ㄉㄚˊ　ㄐ｜ˊ　ㄊㄨㄛ　ㄅㄚ　ㄍㄜ　ㄍㄨㄥˋ　ㄏㄜˊ　ㄍㄨㄛˊ
八音盒	ㄅㄚ　｜ㄣ　ㄏㄜˊ
巴陵戲	ㄅㄚ　ㄌ｜ㄥˊ　ㄒ｜ˋ
巴拉	ㄅㄚ　ㄌㄚ
巴西利亞	ㄅㄚ　ㄒ｜　ㄌ｜ˋ　｜ㄚˋ
拱把	ㄍㄨㄥˇ　ㄅㄚˇ
蝦芭	ㄒ｜ㄚ　˙ㄅㄚ
巴拽	ㄅㄚ　ㄓㄨㄞˋ
巴黎和會	ㄅㄚ　ㄌ｜ˊ　ㄏㄜˊ　ㄏㄨㄟˋ
把細	ㄅㄚˇ　ㄒ｜ˋ
扛鼎拔山	ㄍㄤ　ㄉ｜ㄥˇ　ㄅㄚˊ　ㄕㄢ
大嘴巴	ㄉㄚˋ　ㄗㄨㄟˇ　˙ㄅㄚ
烏七八糟	ㄨ　ㄑ｜　ㄅㄚ　ㄗㄠ
把素	ㄅㄚˇ　ㄙㄨˋ
英拔	｜ㄥ　ㄅㄚˊ
巴拉圭	ㄅㄚ　ㄌㄚ　ㄍㄨㄟ
拔圍出夫	ㄅㄚˊ　ㄨㄟˊ　ㄔㄨ　ㄈㄨ
拔火罐	ㄅㄚˊ　ㄏㄨㄛˇ　ㄍㄨㄢˋ
八千子弟	ㄅㄚ　ㄑ｜ㄢ　ㄗˇ　ㄉ｜ˋ
巴東縣	ㄅㄚ　ㄉㄨㄥ　ㄒ｜ㄢˋ
八月菊	ㄅㄚ　ㄩㄝˋ　ㄐㄩˊ
七跌八撞	ㄑ｜　ㄉ｜ㄝˊ　ㄅㄚ　ㄓㄨㄤˋ
拿一把	ㄋㄚˊ　｜　ㄅㄚˇ
四至八道	ㄙˋ　ㄓˋ　ㄅㄚ　ㄉㄠˋ
拔出	ㄅㄚˊ　ㄔㄨ
狗子夾尾巴	ㄍㄡˇ　˙ㄗ　ㄐ｜ㄚˊ　ㄨㄟˇ　˙ㄅㄚ
變把戲	ㄅ｜ㄢˋ　ㄅㄚˇ　ㄒ｜ˋ
四鄰八舍	ㄙˋ　ㄌ｜ㄣˊ　ㄅㄚ　ㄕㄜˋ
爸爸	ㄅㄚˋ　˙ㄅㄚ
巴黎歌劇院	ㄅㄚ　ㄌ｜ˊ　ㄍㄜ　ㄐㄩˋ　ㄩㄢˋ
拔營	ㄅㄚˊ　｜ㄥˊ
拜把	ㄅㄞˋ　ㄅㄚˇ
八文十二	ㄅㄚ　ㄨㄣˊ　ㄕˊ　ㄦˋ
牽牛拔樁	ㄑ｜ㄢ　ㄋ｜ㄡˊ　ㄅㄚˊ　ㄓㄨㄤ
辛巴達	ㄒ｜ㄣ　ㄅㄚ　ㄉㄚˊ
線板兒	ㄒ｜ㄢˋ　ㄅㄢˇㄦ　(變)ㄒ｜ㄢˋ　ㄅㄚˇㄦ
沒巴沒鼻	ㄇㄟˊ　ㄅㄚ　ㄇㄟˊ　ㄅ｜ˊ
愛巴物兒	ㄞˋ　ㄅㄚ　ㄨˋㄦ
跋步床	ㄅㄚˊ　ㄅㄨˋ　ㄔㄨㄤˊ
芭樂	ㄅㄚ　ㄌㄜˋ
嘎巴兒	ㄍㄚ　˙ㄅㄚㄦ
八掌溪	ㄅㄚ　ㄓㄤˇ　ㄒ｜
喇喇叭叭	ㄌㄚ　˙ㄌㄚ　ㄅㄚ　ㄅㄚ
揭瘡疤	ㄐ｜ㄝ　ㄔㄨㄤ　ㄅㄚ
忽剌八	ㄏㄨ　ㄌㄚˋ　ㄅㄚ
巴斯卡	ㄅㄚ　ㄙ　ㄎㄚˇ
巴船	ㄅㄚ　ㄔㄨㄢˊ
跋扈	ㄅㄚˊ　ㄏㄨˋ
巴勒斯坦解放組織	ㄅㄚ　ㄌㄜˋ　ㄙ　ㄊㄢˇ　ㄐ｜ㄝˇ　ㄈㄤˋ　ㄗㄨˇ　ㄓ
巴格達	ㄅㄚ　ㄍㄜˊ　ㄉㄚˊ
巴米加尼諾	ㄅㄚ　ㄇ｜ˇ　ㄐ｜ㄚ　ㄋ｜ˊ　ㄋㄨㄛˋ
一個跟斗十萬八千里	｜　˙ㄍㄜ　ㄍㄣ　ㄉㄡˇ　ㄕˊ　ㄨㄢˋ　ㄅㄚ　ㄑ｜ㄢ　ㄌ｜ˇ
巴力門	ㄅㄚ　ㄌ｜ˋ　ㄇㄣˊ
八月節	ㄅㄚ　ㄩㄝˋ　ㄐ｜ㄝˊ
靶心	ㄅㄚˇ　ㄒ｜ㄣ
巴巴結結	ㄅㄚ　˙ㄅㄚ　˙ㄐ｜ㄝ　˙ㄐ｜ㄝ
三巴	ㄙㄢ　ㄅㄚ
巴比倫	ㄅㄚ　ㄅ｜ˇ　ㄌㄨㄣˊ
一百八十度	｜　ㄅㄞˇ　ㄅㄚ　ㄕˊ　ㄉㄨˋ
霸	ㄅㄚˋ
八方	ㄅㄚ　ㄈㄤ
古巴共和國	ㄍㄨˇ　ㄅㄚ　ㄍㄨㄥˋ　ㄏㄜˊ　ㄍㄨㄛˊ
萬兒八千	ㄨㄢˋㄦ　ㄅㄚ　ㄑ｜ㄢ　(變)ㄨㄚˋㄦ　ㄅㄚ　ㄑ｜ㄢ
抄靶子	ㄔㄠ　ㄅㄚˇ　˙ㄗ
淋巴球	ㄌ｜ㄣˊ　ㄅㄚ　ㄑ｜ㄡˊ
九一八事變	ㄐ｜ㄡˇ　｜　ㄅㄚ　ㄕˋ　ㄅ｜ㄢˋ
丈八燈臺	ㄓㄤˋ　ㄅㄚ　ㄉㄥ　ㄊㄞˊ
巴掌	ㄅㄚ　˙ㄓㄤ
酒吧	ㄐ｜ㄡˇ　ㄅㄚ
八旗	ㄅㄚ　ㄑ｜ˊ
八通關古道	ㄅㄚ　ㄊㄨㄥ　ㄍㄨㄢ　ㄍㄨˇ　ㄉㄠˋ
胡笳十八拍	ㄏㄨˊ　ㄐ｜ㄚ　ㄕˊ　ㄅㄚ　ㄆㄞ
笆簍	ㄅㄚ　ㄌㄡˇ
八海四瀆	ㄅㄚ　ㄏㄞˇ　ㄙˋ　ㄉㄨˊ
乾吊著下巴	ㄍㄢ　ㄉ｜ㄠˋ　˙ㄓㄜ　ㄒ｜ㄚˋ　˙ㄅㄚ
手把子	ㄕㄡˇ　ㄅㄚˇ　˙ㄗ
霸據	ㄅㄚˋ　ㄐㄩˋ
水壩	ㄕㄨㄟˇ　ㄅㄚˋ
古文八大家	ㄍㄨˇ　ㄨㄣˊ　ㄅㄚ　ㄉㄚˋ　ㄐ｜ㄚ
八仙山	ㄅㄚ　ㄒ｜ㄢ　ㄕㄢ
拔都	ㄅㄚˊ　ㄉㄨ
堤壩	ㄊ｜ˊ　ㄅㄚˋ
巴黎大學	ㄅㄚ　ㄌ｜ˊ　ㄉㄚˋ　ㄒㄩㄝˊ
把來	ㄅㄚˇ　ㄌㄞˊ
兗州八伯	｜ㄢˇ　ㄓㄡ　ㄅㄚ　ㄅㄛˊ
劣把	ㄌ｜ㄝˋ　˙ㄅㄚ
巴拿馬運河新約	ㄅㄚ　ㄋㄚˊ　ㄇㄚˇ　ㄩㄣˋ　ㄏㄜˊ　ㄒ｜ㄣ　ㄩㄝ
疤	ㄅㄚ
刀疤	ㄉㄠ　ㄅㄚ
手把	ㄕㄡˇ　ㄅㄚˇ
七病八痛	ㄑ｜　ㄅ｜ㄥˋ　ㄅㄚ　ㄊㄨㄥˋ
八珍鹹粥	ㄅㄚ　ㄓㄣ　ㄒ｜ㄢˊ　ㄓㄡ
八政	ㄅㄚ　ㄓㄥˋ
老一巴掌	ㄌㄠˇ　｜　ㄅㄚ　˙ㄓㄤ
巴洛克藝術	ㄅㄚ　ㄌㄨㄛˋ　ㄎㄜˋ　｜ˋ　ㄕㄨˋ
夾七夾八	ㄐ｜ㄚˊ　ㄑ｜　ㄐ｜ㄚˊ　ㄅㄚ
漢尼拔	ㄏㄢˋ　ㄋ｜ˊ　ㄅㄚˊ
七老八老	ㄑ｜　ㄌㄠˇ　ㄅㄚ　ㄌㄠˇ
臉巴子	ㄌ｜ㄢˇ　ㄅㄚ　˙ㄗ
奇經八脈	ㄑ｜ˊ　ㄐ｜ㄥ　ㄅㄚ　ㄇㄞˋ
拔頭	ㄅㄚˊ　ㄊㄡˊ
老把勢	ㄌㄠˇ　ㄅㄚˇ　˙ㄕ
武把子	ㄨˇ　ㄅㄚˇ　˙ㄗ
現代芭蕾	ㄒ｜ㄢˋ　ㄉㄞˋ　ㄅㄚ　ㄌㄟˇ
巴油池	ㄅㄚ　｜ㄡˊ　ㄔˊ
爭霸戰	ㄓㄥ　ㄅㄚˋ　ㄓㄢˋ
沒趣巴巴	ㄇㄟˊ　ㄑㄩˋ　ㄅㄚ　ㄅㄚ
跋山涉水	ㄅㄚˊ　ㄕㄢ　ㄕㄜˋ　ㄕㄨㄟˇ
順把	ㄕㄨㄣˋ　ㄅㄚˇ
七大八小	ㄑ｜　ㄉㄚˋ　ㄅㄚ　ㄒ｜ㄠˇ
題跋	ㄊ｜ˊ　ㄅㄚˊ
芭賽	ㄅㄚ　ㄙㄞˋ
撈一把	ㄌㄠ　｜　ㄅㄚˇ
板兒車	ㄅㄢˇㄦ　ㄔㄜ　(變)ㄅㄚˇㄦ　ㄔㄜ
巴駱和	ㄅㄚ　ㄌㄨㄛˋ　ㄏㄜˊ
把子	ㄅㄚˇ　˙ㄗ,ㄅㄚˋ　˙ㄗ
絕塵拔俗	ㄐㄩㄝˊ　ㄔㄣˊ　ㄅㄚˊ　ㄙㄨˊ
拔地	ㄅㄚˊ　ㄉ｜ˋ
十八姨	ㄕˊ　ㄅㄚ　｜ˊ
把筆	ㄅㄚˇ　ㄅ｜ˇ
八拜	ㄅㄚ　ㄅㄞˋ
喝啞吧酒	ㄏㄜ　｜ㄚˇ　˙ㄅㄚ　ㄐ｜ㄡˇ
八苦	ㄅㄚ　ㄎㄨˇ
巴倫支海	ㄅㄚ　ㄌㄨㄣˊ　ㄓ　ㄏㄞˇ
皺巴巴	ㄓㄡˋ　ㄅㄚ　ㄅㄚ
加把勁	ㄐ｜ㄚ　ㄅㄚˇ　ㄐ｜ㄣˋ
把定	ㄅㄚˇ　ㄉ｜ㄥˋ
巴著	ㄅㄚ　ㄓㄠˊ
巴羔子	ㄅㄚ　ㄍㄠ　˙ㄗ
八百羅漢	ㄅㄚ　ㄅㄞˇ　ㄌㄨㄛˊ　ㄏㄢˋ
八戒	ㄅㄚ　ㄐ｜ㄝˋ
八成	ㄅㄚ　ㄔㄥˊ
把守	ㄅㄚˇ　ㄕㄡˇ
灞陵園	ㄅㄚˋ　ㄌ｜ㄥˊ　ㄩㄢˊ
把家	ㄅㄚˇ　ㄐ｜ㄚ
巴西聯邦共和國	ㄅㄚ　ㄒ｜　ㄌ｜ㄢˊ　ㄅㄤ　ㄍㄨㄥˋ　ㄏㄜˊ　ㄍㄨㄛˊ
半塗而罷	ㄅㄢˋ　ㄊㄨˊ　ㄦˊ　ㄅㄚˋ
打牙巴骨	ㄉㄚˇ　｜ㄚˊ　ㄅㄚ　ㄍㄨˇ
罷兵	ㄅㄚˋ　ㄅ｜ㄥ
靶場	ㄅㄚˇ　ㄔㄤˊ
色字頭上一把刀	ㄙㄜˋ　ㄗˋ　ㄊㄡˊ　ㄕㄤˋ　｜　ㄅㄚˇ　ㄉㄠ
大巴山脈	ㄉㄚˋ　ㄅㄚ　ㄕㄢ　ㄇㄞˋ
罷黜	ㄅㄚˋ　ㄔㄨˋ
八月花神	ㄅㄚ　ㄩㄝˋ　ㄏㄨㄚ　ㄕㄣˊ
把定物	ㄅㄚˇ　ㄉ｜ㄥˋ　ㄨˋ
罷免	ㄅㄚˋ　ㄇ｜ㄢˇ
八進制	ㄅㄚ　ㄐ｜ㄣˋ　ㄓˋ
伊斯蘭馬巴德	｜　ㄙ　ㄌㄢˊ　ㄇㄚˇ　ㄅㄚ　ㄉㄜˊ
吹喇叭	ㄔㄨㄟ　ㄌㄚˇ　˙ㄅㄚ
箭靶子	ㄐ｜ㄢˋ　ㄅㄚˇ　˙ㄗ
拔白	ㄅㄚˊ　ㄅㄞˊ
粑	ㄅㄚ
跋扈自恣	ㄅㄚˊ　ㄏㄨˋ　ㄗˋ　ㄗˋ
八字帖	ㄅㄚ　ㄗˋ　ㄊ｜ㄝˇ
清拔	ㄑ｜ㄥ　ㄅㄚˊ
八大八	ㄅㄚ　ㄉㄚˋ　ㄅㄚ
丘八	ㄑ｜ㄡ　ㄅㄚ
八面光	ㄅㄚ　ㄇ｜ㄢˋ　ㄍㄨㄤ
跋文	ㄅㄚˊ　ㄨㄣˊ
八莫	ㄅㄚ　ㄇㄛˋ
經濟罷工	ㄐ｜ㄥ　ㄐ｜ˋ　ㄅㄚˋ　ㄍㄨㄥ
芭蕉洞	ㄅㄚ　ㄐ｜ㄠ　ㄉㄨㄥˋ
出群拔萃	ㄔㄨ　ㄑㄩㄣˊ　ㄅㄚˊ　ㄘㄨㄟˋ
不如意恆七八	ㄅㄨˋ　ㄖㄨˊ　｜ˋ　ㄏㄥˊ　ㄑ｜　ㄅㄚ
現代芭蕾舞	ㄒ｜ㄢˋ　ㄉㄞˋ　ㄅㄚ　ㄌㄟˇ　ㄨˇ
使絆兒	ㄕˇ　ㄅㄢˋㄦ　(變)ㄕˇ　ㄅㄚˋㄦ
毛團把戲	ㄇㄠˊ　ㄊㄨㄢˊ　ㄅㄚˇ　ㄒ｜ˋ
捏把汗	ㄋ｜ㄝ　ㄅㄚˇ　ㄏㄢˋ
巴斗	ㄅㄚ　ㄉㄡˇ
刀把兒	ㄉㄠ　ㄅㄚˋㄦ
丫巴兒	｜ㄚ　˙ㄅㄚㄦ
鈸	ㄅㄚˊ
繃扒	ㄅㄥ　ㄅㄚ
舊瘡疤	ㄐ｜ㄡˋ　ㄔㄨㄤ　ㄅㄚ
巴山縣	ㄅㄚ　ㄕㄢ　ㄒ｜ㄢˋ
壩	ㄅㄚˋ
巴斯噶	ㄅㄚ　ㄙ　ㄍㄜˊ
巴斯	ㄅㄚ　ㄙ
把穩	ㄅㄚˇ　ㄨㄣˇ
巴巴急急	ㄅㄚ　˙ㄅㄚ　˙ㄐ｜　˙ㄐ｜
鎗把	ㄑ｜ㄤ　ㄅㄚˇ
零七八碎	ㄌ｜ㄥˊ　ㄑ｜　ㄅㄚ　ㄙㄨㄟˋ
拿刀靶兒	ㄋㄚˊ　ㄉㄠ　ㄅㄚˇㄦ
霸陵醉尉	ㄅㄚˋ　ㄌ｜ㄥˊ　ㄗㄨㄟˋ　ㄨㄟˋ
耙	（又音）ㄅㄚˋ
巴蕾	ㄅㄚ　ㄌㄟˇ
繃扒吊拷	ㄅㄥ　ㄅㄚ　ㄉ｜ㄠˋ　ㄎㄠˇ
拔茅連茹	ㄅㄚˊ　ㄇㄠˊ　ㄌ｜ㄢˊ　ㄖㄨˊ
提拔	ㄊ｜ˊ　ㄅㄚˊ
罷退	ㄅㄚˋ　ㄊㄨㄟˋ
烏龜亡八	ㄨ　ㄍㄨㄟ　ㄨㄤˊ　ㄅㄚ
巴貝克	ㄅㄚ　ㄅㄟˋ　ㄎㄜˋ
百八丸	ㄅㄞˇ　ㄅㄚ　ㄨㄢˊ
巴攔	ㄅㄚ　ㄌㄢˊ
喇叭口兒	ㄌㄚˇ　˙ㄅㄚ　ㄎㄡˇㄦ
不幹這把刀	ㄅㄨˋ　ㄍㄢˋ　ㄓㄜˋ　ㄅㄚˇ　ㄉㄠ
八荒	ㄅㄚ　ㄏㄨㄤ
巴攀	ㄅㄚ　ㄆㄢ
哲布尊丹巴	ㄓㄜˊ　ㄅㄨˋ　ㄗㄨㄣ　ㄉㄢ　ㄅㄚ
霸才	ㄅㄚˋ　ㄘㄞˊ
七拉八扯	ㄑ｜　ㄌㄚ　ㄅㄚ　ㄔㄜˇ
七折八扣	ㄑ｜　ㄓㄜˊ　ㄅㄚ　ㄎㄡˋ
巴攬	ㄅㄚ　ㄌㄢˇ
大喇叭	ㄉㄚˋ　ㄌㄚˇ　˙ㄅㄚ
撚靶兒	ㄋ｜ㄢˇ　ㄅㄚˇㄦ
笆斗	ㄅㄚ　ㄉㄡˇ
鬼把戲	ㄍㄨㄟˇ　ㄅㄚˇ　ㄒ｜ˋ
都把勢	ㄉㄨ　ㄅㄚˇ　˙ㄕ
巴蛇	ㄅㄚ　ㄕㄜˊ
把兒鏡子	ㄅㄚˋㄦ　ㄐ｜ㄥˋ　˙ㄗ
拔睹兒	ㄅㄚˊ　ㄉㄨˇ　ㄦˊ
巴蛾	ㄅㄚ　ㄜˊ
八仙過海	ㄅㄚ　ㄒ｜ㄢ　ㄍㄨㄛˋ　ㄏㄞˇ
八股	ㄅㄚ　ㄍㄨˇ
巴戟天	ㄅㄚ　ㄐ｜ˇ　ㄊ｜ㄢ
巴拉拉卡琴	ㄅㄚ　ㄌㄚ　ㄌㄚ　ㄎㄚˇ　ㄑ｜ㄣˊ
爸	ㄅㄚˋ
巴拿馬運河	ㄅㄚ　ㄋㄚˊ　ㄇㄚˇ　ㄩㄣˋ　ㄏㄜˊ
王八羔子	ㄨㄤˊ　˙ㄅㄚ　ㄍㄠ　˙ㄗ
扒房	ㄅㄚ　ㄈㄤˊ
四起八拜	ㄙˋ　ㄑ｜ˇ　ㄅㄚ　ㄅㄞˋ
連根拔起	ㄌ｜ㄢˊ　ㄍㄣ　ㄅㄚˊ　ㄑ｜ˇ
長尾巴	ㄓㄤˇ　ㄨㄟˇ　˙ㄅㄚ
才高八斗	ㄘㄞˊ　ㄍㄠ　ㄅㄚ　ㄉㄡˇ
尿尿把把	ㄋ｜ㄠˋ　ㄋ｜ㄠˋ　ㄅㄚˇ　ㄅㄚˇ
扒得高跌得重	ㄅㄚ　˙ㄉㄜ　ㄍㄠ　ㄉ｜ㄝˊ　˙ㄉㄜ　ㄓㄨㄥˋ
靶	ㄅㄚˇ
八角茴香	ㄅㄚ　ㄐ｜ㄠˇ　ㄏㄨㄟˊ　ㄒ｜ㄤ
八老	ㄅㄚ　ㄌㄠˇ
眨巴	ㄓㄚˇ　˙ㄅㄚ
淋巴瘤	ㄌ｜ㄣˊ　ㄅㄚ　ㄌ｜ㄡˊ
把如	ㄅㄚˇ　ㄖㄨˊ
撇罷	ㄆ｜ㄝ　ㄅㄚˋ
拔關	ㄅㄚˊ　ㄍㄨㄢ
巴高枝兒	ㄅㄚ　ㄍㄠ　ㄓㄦ　(變)ㄅㄚ　ㄍㄠ　ㄓㄜㄦ
瞎七瞎八	ㄒ｜ㄚ　ㄑ｜　ㄒ｜ㄚ　ㄅㄚ
八面鋒	ㄅㄚ　ㄇ｜ㄢˋ　ㄈㄥ
十中八九	ㄕˊ　ㄓㄨㄥˋ　ㄅㄚ　ㄐ｜ㄡˇ
把飯叫饑	ㄅㄚˇ　ㄈㄢˋ　ㄐ｜ㄠˋ　ㄐ｜
巴巴罾兒	ㄅㄚ　ㄅㄚ　ㄗㄥˋㄦ
七窩八代	ㄑ｜　ㄨㄛ　ㄅㄚ　ㄉㄞˋ
黎巴嫩共和國	ㄌ｜ˊ　ㄅㄚ　ㄋㄣˋ　ㄍㄨㄥˋ　ㄏㄜˊ　ㄍㄨㄛˊ
八棒十三的罪過	ㄅㄚ　ㄅㄤˋ　ㄕˊ　ㄙㄢ　˙ㄉㄜ　ㄗㄨㄟˋ　ㄍㄨㄛˋ
沒臉的忘八蛋	ㄇㄟˊ　ㄌ｜ㄢˇ　˙ㄉㄜ　ㄨㄤˋ　ㄅㄚ　ㄉㄢˋ
臘八	ㄌㄚˋ　ㄅㄚ
客家八音	ㄎㄜˋ　ㄐ｜ㄚ　ㄅㄚ　｜ㄣ
七爺八爺	ㄑ｜　｜ㄝˊ　ㄅㄚ　｜ㄝˊ
蔥白兒	ㄘㄨㄥ　ㄅㄞˊㄦ　(變)ㄘㄨㄥ　ㄅㄚˊㄦ
擢拔	ㄓㄨㄛˊ　ㄅㄚˊ
眼觀六路，耳聽八方	｜ㄢˇ　ㄍㄨㄢ　ㄌ｜ㄡˋ　ㄌㄨˋ　ㄦˇ　ㄊ｜ㄥ　ㄅㄚ　ㄈㄤ
吊拷繃扒	ㄉ｜ㄠˋ　ㄎㄠˇ　ㄅㄥ　ㄅㄚ
巴爾幹山脈	ㄅㄚ　ㄦˇ　ㄍㄢˋ　ㄕㄢ　ㄇㄞˋ
跋涉山川	ㄅㄚˊ　ㄕㄜˋ　ㄕㄢ　ㄔㄨㄢ
打牆板兒翻上下	ㄉㄚˇ　ㄑ｜ㄤˊ　ㄅㄢˇㄦ　ㄈㄢ　ㄕㄤˋ　ㄒ｜ㄚˋ　(變)ㄉㄚˇ　ㄑ｜ㄤˊ　ㄅㄚˇㄦ　ㄈㄢ　ㄕㄤˋ　ㄒ｜ㄚˋ
巴柄	ㄅㄚ　ㄅ｜ㄥˇ
喊七叫八	ㄏㄢˇ　ㄑ｜　ㄐ｜ㄠˋ　ㄅㄚ
王八看綠豆	ㄨㄤˊ　˙ㄅㄚ　ㄎㄢˋ　ㄌㄩˋ　ㄉㄡˋ
巨毋霸	ㄐㄩˋ　ㄨˊ　ㄅㄚˋ
把場	ㄅㄚˇ　ㄔㄤˊ
壩子	ㄅㄚˋ　˙ㄗ
把頭	ㄅㄚˇ　ㄊㄡˊ
蒜瓣兒	ㄙㄨㄢˋ　ㄅㄢˋㄦ　(變)ㄙㄨㄢˋ　ㄅㄚˋㄦ
把素持齋	ㄅㄚˇ　ㄙㄨˋ　ㄔˊ　ㄓㄞ
拖尾巴	ㄊㄨㄛ　ㄨㄟˇ　˙ㄅㄚ
巴拉圭共和國	ㄅㄚ　ㄌㄚ　ㄍㄨㄟ　ㄍㄨㄥˋ　ㄏㄜˊ　ㄍㄨㄛˊ
巴林	ㄅㄚ　ㄌ｜ㄣˊ
急急巴巴	ㄐ｜ˊ　˙ㄐ｜　ㄅㄚ　ㄅㄚ
八卦丹	ㄅㄚ　ㄍㄨㄚˋ　ㄉㄢ
阿米巴痢疾	ㄚ　ㄇ｜ˇ　ㄅㄚ　ㄌ｜ˋ　ㄐ｜ˊ
空中霸王	ㄎㄨㄥ　ㄓㄨㄥ　ㄅㄚˋ　ㄨㄤˊ
八大錘	ㄅㄚ　ㄉㄚˋ　ㄔㄨㄟˊ
八面見光	ㄅㄚ　ㄇ｜ㄢˋ　ㄐ｜ㄢˋ　ㄍㄨㄤ
光巴	ㄍㄨㄤ　˙ㄅㄚ
眼觀四處，耳聽八方	｜ㄢˇ　ㄍㄨㄢ　ㄙˋ　ㄔㄨˋ　ㄦˇ　ㄊ｜ㄥ　ㄅㄚ　ㄈㄤ
十郎八當	ㄕˊ　ㄌㄤˊ　ㄅㄚ　ㄉㄤ
堅韌不拔	ㄐ｜ㄢ　ㄖㄣˋ　ㄅㄨˋ　ㄅㄚˊ
吉里巴斯共和國	ㄐ｜ˊ　ㄌ｜ˇ　ㄅㄚ　ㄙ　ㄍㄨㄥˋ　ㄏㄜˊ　ㄍㄨㄛˊ
二八年華	ㄦˋ　ㄅㄚ　ㄋ｜ㄢˊ　ㄏㄨㄚˊ
巴郎鼓	ㄅㄚ　ㄌㄤˊ　ㄍㄨˇ
拔了一個尖兒	ㄅㄚˊ　˙ㄌㄜ　｜　˙ㄍㄜ　ㄐ｜ㄢㄦ　(變)ㄅㄚˊ　˙ㄌㄜ　｜ˊ　˙ㄍㄜ　ㄐ｜ㄚㄦ
灞水	ㄅㄚˋ　ㄕㄨㄟˇ
霸者	ㄅㄚˋ　ㄓㄜˇ
靶子	ㄅㄚˇ　˙ㄗ
官板兒	ㄍㄨㄢ　ㄅㄢˇㄦ　(變)ㄍㄨㄢ　ㄅㄚˇㄦ
疤瘌眼	ㄅㄚ　˙ㄌㄚ　｜ㄢˇ
和尚吃八方	ㄏㄜˊ　ㄕㄤˋ　ㄔ　ㄅㄚ　ㄈㄤ
明忘八	ㄇ｜ㄥˊ　ㄨㄤˊ　ㄅㄚ
巴望	ㄅㄚ　ㄨㄤˋ
七個八個	ㄑ｜　˙ㄍㄜ　ㄅㄚ　˙ㄍㄜ
八面受敵	ㄅㄚ　ㄇ｜ㄢˋ　ㄕㄡˋ　ㄉ｜ˊ
把突兒	ㄅㄚˇ　ㄊㄨˊㄦ
巴勒特	ㄅㄚ　ㄌㄜˋ　ㄊㄜˋ
隔著窗戶吹喇叭	ㄍㄜˊ　˙ㄓㄜ　ㄔㄨㄤ　˙ㄏㄨ　ㄔㄨㄟ　ㄌㄚˇ　˙ㄅㄚ
四停八當	ㄙˋ　ㄊ｜ㄥˊ　ㄅㄚ　ㄉㄤˋ
札板兒	ㄓㄚˊ　ㄅㄢˇㄦ　(變)ㄓㄚˊ　ㄅㄚˇㄦ
牢不可拔	ㄌㄠˊ　ㄅㄨˋ　ㄎㄜˇ　ㄅㄚˊ
豝	ㄅㄚ
第一把手	ㄉ｜ˋ　｜　ㄅㄚˇ　ㄕㄡˇ
巴蜀	ㄅㄚ　ㄕㄨˇ
歐羅巴州	ㄡ　ㄌㄨㄛˊ　ㄅㄚ　ㄓㄡ
車把式	ㄔㄜ　ㄅㄚˇ　˙ㄕ
八音匣	ㄅㄚ　｜ㄣ　ㄒ｜ㄚˊ
五行八作	ㄨˇ　ㄏㄤˊ　ㄅㄚ　ㄗㄨㄛ
八寶菜	ㄅㄚ　ㄅㄠˇ　ㄘㄞˋ
拔新領異	ㄅㄚˊ　ㄒ｜ㄣ　ㄌ｜ㄥˇ　｜ˋ
巴勒維	ㄅㄚ　ㄌㄜˋ　ㄨㄟˊ
乾巴	ㄍㄢ　˙ㄅㄚ
巴棍	ㄅㄚ　ㄍㄨㄣˋ
八聖道	ㄅㄚ　ㄕㄥˋ　ㄉㄠˋ
密勒日巴	ㄇ｜ˋ　ㄌㄜˋ　ㄖˋ　ㄅㄚ
二二八事件	ㄦˋ　ㄦˋ　ㄅㄚ　ㄕˋ　ㄐ｜ㄢˋ
丁壩	ㄉ｜ㄥ　ㄅㄚˋ
七青八黃	ㄑ｜　ㄑ｜ㄥ　ㄅㄚ　ㄏㄨㄤˊ
七歪八扭	ㄑ｜　ㄨㄞ　ㄅㄚ　ㄋ｜ㄡˇ
罷工	ㄅㄚˋ　ㄍㄨㄥ
靶兒鏡子	ㄅㄚˇㄦ　ㄐ｜ㄥˋ　˙ㄗ
有兩把刷子	｜ㄡˇ　ㄌ｜ㄤˇ　ㄅㄚˇ　ㄕㄨㄚ　˙ㄗ
皮板兒	ㄆ｜ˊ　ㄅㄢˇㄦ　(變)ㄆ｜ˊ　ㄅㄚˇㄦ
八仙	ㄅㄚ　ㄒ｜ㄢ
菝	ㄅㄚˊ
八代	ㄅㄚ　ㄉㄞˋ
八無暇	ㄅㄚ　ㄨˊ　ㄒ｜ㄚˊ
二十八星瓢蟲	ㄦˋ　ㄕˊ　ㄅㄚ　ㄒ｜ㄥ　ㄆ｜ㄠˊ　ㄔㄨㄥˊ
扒拉	ㄅㄚ　˙ㄌㄚ
跋前疐後	ㄅㄚˊ　ㄑ｜ㄢˊ　ㄓˋ　ㄏㄡˋ
淡巴菰	ㄉㄢˋ　ㄅㄚ　ㄍㄨ
巴巴兒的	ㄅㄚ　ㄅㄚㄦ　˙ㄉㄜ
把臂入林	ㄅㄚˇ　ㄅ｜ˋ　ㄖㄨˋ　ㄌ｜ㄣˊ
一把	｜　ㄅㄚˇ
八不	ㄅㄚ　ㄅㄨˋ
拔寨	ㄅㄚˊ　ㄓㄞˋ
泥巴	ㄋ｜ˊ　ㄅㄚ
話把	ㄏㄨㄚˋ　ㄅㄚˋ
八音	ㄅㄚ　｜ㄣ
鼥	ㄅㄚˊ
頓巴敦橡園會議	ㄉㄨㄣˋ　ㄅㄚ　ㄉㄨㄣ　ㄒ｜ㄤˋ　ㄩㄢˊ　ㄏㄨㄟˋ　｜ˋ
十八層地獄	ㄕˊ　ㄅㄚ　ㄘㄥˊ　ㄉ｜ˋ　ㄩˋ
罷崗	ㄅㄚˋ　ㄍㄤˇ
巴伐利亞	ㄅㄚ　ㄈㄚˊ　ㄌ｜ˋ　｜ㄚˋ
拔節	ㄅㄚˊ　ㄐ｜ㄝˊ
磕巴	ㄎㄜ　˙ㄅㄚ
一折八扣	｜　ㄓㄜˊ　ㄅㄚ　ㄎㄡˋ
十八般武藝	ㄕˊ　ㄅㄚ　ㄅㄢ　ㄨˇ　｜ˋ
八九	ㄅㄚ　ㄐ｜ㄡˇ
忘八	ㄨㄤˊ　˙ㄅㄚ
辛巴威	ㄒ｜ㄣ　ㄅㄚ　ㄨㄟ
巴布亞紐幾內亞	ㄅㄚ　ㄅㄨˋ　｜ㄚˋ　ㄋ｜ㄡˇ　ㄐ｜　ㄋㄟˋ　｜ㄚˋ
十八界	ㄕˊ　ㄅㄚ　ㄐ｜ㄝˋ
粽粑葉	ㄗㄨㄥˋ　ㄅㄚ　｜ㄝˋ
拔宅	ㄅㄚˊ　ㄓㄞˊ
八十年不下雨	ㄅㄚ　ㄕˊ　ㄋ｜ㄢˊ　ㄅㄨˋ　ㄒ｜ㄚˋ　ㄩˇ
捏了一把汗	ㄋ｜ㄝ　˙ㄌㄜ　｜　ㄅㄚˇ　ㄏㄢˋ
八輩兒五沒根基	ㄅㄚ　ㄅㄟˋㄦ　ㄨˇ　ㄇㄟˊ　ㄍㄣ　ㄐ｜　(變)ㄅㄚˊ　ㄅㄜˋㄦ　ㄨˇ　ㄇㄟˊ　ㄍㄣ　ㄐ｜
巴士低溫殺菌法	ㄅㄚ　ㄕˋ　ㄉ｜　ㄨㄣ　ㄕㄚ　ㄐㄩㄣˋ　ㄈㄚˇ
吧檯	ㄅㄚ　ㄊㄞˊ
八辟	ㄅㄚ　ㄅ｜ˋ
斥罷	ㄔˋ　ㄅㄚˋ
力把兒頭	ㄌ｜ˋ　˙ㄅㄚㄦ　ㄊㄡˊ
鄉巴佬	ㄒ｜ㄤ　ㄅㄚ　ㄌㄠˇ
斯巴達教育	ㄙ　ㄅㄚ　ㄉㄚˊ　ㄐ｜ㄠˋ　ㄩˋ
三八制	ㄙㄢ　ㄅㄚ　ㄓˋ
攔河壩	ㄌㄢˊ　ㄏㄜˊ　ㄅㄚˋ
巴解	ㄅㄚ　ㄐ｜ㄝˇ
巴拿馬地峽	ㄅㄚ　ㄋㄚˊ　ㄇㄚˇ　ㄉ｜ˋ　ㄒ｜ㄚˊ
拔濟火宅	ㄅㄚˊ　ㄐ｜ˋ　ㄏㄨㄛˇ　ㄓㄞˊ
八俊	ㄅㄚ　ㄐㄩㄣˋ
二十八宿	ㄦˋ　ㄕˊ　ㄅㄚ　ㄒ｜ㄡˋ
車把	ㄔㄜ　ㄅㄚˇ
袞州八伯	ㄍㄨㄣˇ　ㄓㄡ　ㄅㄚ　ㄅㄛˊ
問七問八	ㄨㄣˋ　ㄑ｜　ㄨㄣˋ　ㄅㄚ
陳霸先	ㄔㄣˊ　ㄅㄚˋ　ㄒ｜ㄢ
新官上任三把火	ㄒ｜ㄣ　ㄍㄨㄢ　ㄕㄤˋ　ㄖㄣˋ　ㄙㄢ　ㄅㄚˇ　ㄏㄨㄛˇ
海拔	ㄏㄞˇ　ㄅㄚˊ
春秋五霸	ㄔㄨㄣ　ㄑ｜ㄡ　ㄨˇ　ㄅㄚˋ
扒拉大山	ㄅㄚ　ㄌㄚ　ㄉㄚˋ　ㄕㄢ
茇	ㄅㄚˊ
巴士噶語言	ㄅㄚ　ㄕˋ　ㄍㄜˊ　ㄩˇ　｜ㄢˊ
霸主	ㄅㄚˋ　ㄓㄨˇ
下巴	ㄒ｜ㄚˋ　˙ㄅㄚ
力把	ㄌ｜ˋ　˙ㄅㄚ
由跋	｜ㄡˊ　ㄅㄚˊ
霸上	ㄅㄚˋ　ㄕㄤˋ
巴西	ㄅㄚ　ㄒ｜
薦拔	ㄐ｜ㄢˋ　ㄅㄚˊ
拔高	ㄅㄚˊ　ㄍㄠ
雄霸一方	ㄒㄩㄥˊ　ㄅㄚˋ　｜　ㄈㄤ
八伯	ㄅㄚ　ㄅㄛˊ
伯	ㄅㄚˋ
拔葵啖棗	ㄅㄚˊ　ㄎㄨㄟˊ　ㄉㄢˋ　ㄗㄠˇ
翻把	ㄈㄢ　ㄅㄚˇ
把盞	ㄅㄚˇ　ㄓㄢˇ
有把握	｜ㄡˇ　ㄅㄚˇ　ㄨㄛˋ
酒八仙人	ㄐ｜ㄡˇ　ㄅㄚ　ㄒ｜ㄢ　ㄖㄣˊ
鍋巴	ㄍㄨㄛ　ㄅㄚ
粑粑	ㄅㄚ　ㄅㄚ
隨驢把馬	ㄙㄨㄟˊ　ㄌㄩˊ　ㄅㄚˇ　ㄇㄚˇ
巴什吉爾自治共和國	ㄅㄚ　ㄕˊ　ㄐ｜ˊ　ㄦˇ　ㄗˋ　ㄓˋ　ㄍㄨㄥˋ　ㄏㄜˊ　ㄍㄨㄛˊ
自拔	ㄗˋ　ㄅㄚˊ
東巴文	ㄉㄨㄥ　ㄅㄚ　ㄨㄣˊ
巴寡婦清	ㄅㄚ　ㄍㄨㄚˇ　ㄈㄨˋ　ㄑ｜ㄥ
虎辣八	ㄏㄨˇ　ㄌㄚˋ　ㄅㄚ
巴兒狗	ㄅㄚㄦ　ㄍㄡˇ
水上芭蕾	ㄕㄨㄟˇ　ㄕㄤˋ　ㄅㄚ　ㄌㄟˇ
八佾	ㄅㄚ　｜ˋ
拔突	ㄅㄚˊ　ㄊㄨˊ
霸王卸甲	ㄅㄚˋ　ㄨㄤˊ　ㄒ｜ㄝˋ　ㄐ｜ㄚˇ
俊拔	ㄐㄩㄣˋ　ㄅㄚˊ
八年抗戰	ㄅㄚ　ㄋ｜ㄢˊ　ㄎㄤˋ　ㄓㄢˋ
巴高望上	ㄅㄚ　ㄍㄠ　ㄨㄤˋ　ㄕㄤˋ
芭拉	ㄅㄚ　ㄌㄚ
巴尖兒好勝	ㄅㄚ　ㄐ｜ㄢㄦ　ㄏㄠˋ　ㄕㄥˋ　(變)ㄅㄚ　ㄐ｜ㄚㄦ　ㄏㄠˋ　ㄕㄥˋ
巴三覽四	ㄅㄚ　ㄙㄢ　ㄌㄢˇ　ㄙˋ
專恣跋扈	ㄓㄨㄢ　ㄗˋ　ㄅㄚˊ　ㄏㄨˋ
七張八嘴	ㄑ｜　ㄓㄤ　ㄅㄚ　ㄗㄨㄟˇ
黎巴嫩	ㄌ｜ˊ　ㄅㄚ　ㄋㄣˋ
芭苴	ㄅㄚ　ㄐㄩˇ
拔奇	ㄅㄚˊ　ㄑ｜ˊ
跋語	ㄅㄚˊ　ㄩˇ
鴨霸	｜ㄚ　ㄅㄚˋ
三綱八目	ㄙㄢ　ㄍㄤ　ㄅㄚ　ㄇㄨˋ
八法	ㄅㄚ　ㄈㄚˇ
芭芒	ㄅㄚ　ㄇㄤˊ
告老打罷	ㄍㄠˋ　ㄌㄠˇ　ㄉㄚˇ　ㄅㄚˋ
錢板兒	ㄑ｜ㄢˊ　ㄅㄢˇㄦ　(變)ㄑ｜ㄢˊ　ㄅㄚˇㄦ
乾巴巴	ㄍㄢ　ㄅㄚ　ㄅㄚ
淋巴結	ㄌ｜ㄣˊ　ㄅㄚ　ㄐ｜ㄝˊ
芭蕉扇	ㄅㄚ　ㄐ｜ㄠ　ㄕㄢˋ
鐃鈸	ㄋㄠˊ　ㄅㄚˊ
巴利語	ㄅㄚ　ㄌ｜ˋ　ㄩˇ
乾罷	ㄍㄢ　ㄅㄚˋ
把兄弟	ㄅㄚˇ　ㄒㄩㄥ　ㄉ｜ˋ
打靶場	ㄉㄚˇ　ㄅㄚˇ　ㄔㄤˊ
把門	ㄅㄚˇ　ㄇㄣˊ
芭蕉芋	ㄅㄚ　ㄐ｜ㄠ　ㄩˋ
八大胡同	ㄅㄚ　ㄉㄚˋ　ㄏㄨˊ　˙ㄊㄨㄥ
西楚霸王	ㄒ｜　ㄔㄨˇ　ㄅㄚˋ　ㄨㄤˊ
吉里巴斯	ㄐ｜ˊ　ㄌ｜ˇ　ㄅㄚ　ㄙ
跋涉千里	ㄅㄚˊ　ㄕㄜˋ　ㄑ｜ㄢ　ㄌ｜ˇ
八九不離十	ㄅㄚ　ㄐ｜ㄡˇ　ㄅㄨˋ　ㄌ｜ˊ　ㄕˊ
拔禾	ㄅㄚˊ　ㄏㄜˊ
倔巴	ㄐㄩㄝˋ　˙ㄅㄚ
哈巴狗	ㄏㄚˇ　˙ㄅㄚ　ㄍㄡˇ
啞巴吃黃蓮	｜ㄚˇ　˙ㄅㄚ　ㄔ　ㄏㄨㄤˊ　ㄌ｜ㄢˊ
評詙	ㄆ｜ㄥˊ　ㄅㄚˊ
拔脯子	ㄅㄚˊ　ㄆㄨˊ　˙ㄗ
也罷	｜ㄝˇ　ㄅㄚˋ
抽丁拔楔	ㄔㄡ　ㄉ｜ㄥ　ㄅㄚˊ　ㄒ｜ㄝˋ
灞橋	ㄅㄚˋ　ㄑ｜ㄠˊ
巴洛馬天文臺	ㄅㄚ　ㄌㄨㄛˋ　ㄇㄚˇ　ㄊ｜ㄢ　ㄨㄣˊ　ㄊㄞˊ
乾白兒	ㄍㄢ　ㄅㄞˊㄦ　(變)ㄍㄢ　ㄅㄚˊㄦ
拔虎鬚	ㄅㄚˊ　ㄏㄨˇ　ㄒㄩ
手巾把子	ㄕㄡˇ　ㄐ｜ㄣ　ㄅㄚˇ　˙ㄗ
離弦走板兒	ㄌ｜ˊ　ㄒ｜ㄢˊ　ㄗㄡˇ　ㄅㄢˇㄦ　(變)ㄌ｜ˊ　ㄒ｜ㄢˊ　ㄗㄡˇ　ㄅㄚˇㄦ
罷麼	ㄅㄚˋ　˙ㄇㄜ
波霸	ㄅㄛ　ㄅㄚˋ
八都兒	ㄅㄚ　ㄉㄨ　ㄦˊ
路霸	ㄌㄨˋ　ㄅㄚˋ
壩址	ㄅㄚˋ　ㄓˇ
倒把	ㄉㄠˇ　ㄅㄚˇ
露出了狐狸尾巴	ㄌㄡˋ　ㄔㄨ　˙ㄌㄜ　ㄏㄨˊ　˙ㄌ｜　ㄨㄟˇ　˙ㄅㄚ
掐巴	ㄑ｜ㄚ　˙ㄅㄚ
巴力斯坦	ㄅㄚ　ㄌ｜ˋ　ㄙ　ㄊㄢˇ
一把子	｜　ㄅㄚˇ　˙ㄗ
槍靶	ㄑ｜ㄤ　ㄅㄚˇ
厄爾巴島	ㄜˋ　ㄦˇ　ㄅㄚ　ㄉㄠˇ
八子七婿	ㄅㄚ　ㄗˇ　ㄑ｜　ㄒㄩˋ
拔釘鎚	ㄅㄚˊ　ㄉ｜ㄥ　ㄔㄨㄟˊ
芭蕾舞	ㄅㄚ　ㄌㄟˇ　ㄨˇ
扒頭探腦	ㄅㄚ　ㄊㄡˊ　ㄊㄢˋ　ㄋㄠˇ
壩基	ㄅㄚˋ　ㄐ｜
加拉巴哥群島	ㄐ｜ㄚ　ㄌㄚ　ㄅㄚ　ㄍㄜ　ㄑㄩㄣˊ　ㄉㄠˇ
八卦拳	ㄅㄚ　ㄍㄨㄚˋ　ㄑㄩㄢˊ
翻把恩人當仇人	ㄈㄢ　ㄅㄚˇ　ㄣ　ㄖㄣˊ　ㄉㄤˋ　ㄔㄡˊ　ㄖㄣˊ
霸氣	ㄅㄚˋ　ㄑ｜ˋ
二二八和平公園	ㄦˋ　ㄦˋ　ㄅㄚ　ㄏㄜˊ　ㄆ｜ㄥˊ　ㄍㄨㄥ　ㄩㄢˊ
連霸	ㄌ｜ㄢˊ　ㄅㄚˋ
張弓拔刃	ㄓㄤ　ㄍㄨㄥ　ㄅㄚˊ　ㄖㄣˋ
一把鼻涕，一包眼淚	｜　ㄅㄚˇ　ㄅ｜ˊ　ㄊ｜ˋ　｜　ㄅㄠ　｜ㄢˇ　ㄌㄟˋ
超拔	ㄔㄠ　ㄅㄚˊ
八洞	ㄅㄚ　ㄉㄨㄥˋ
巴前算後	ㄅㄚ　ㄑ｜ㄢˊ　ㄙㄨㄢˋ　ㄏㄡˋ
罷市	ㄅㄚˋ　ㄕˋ
八分書	ㄅㄚ　ㄈㄣ　ㄕㄨ
撒巴掌	ㄙㄚ　ㄅㄚ　ㄓㄤˇ
官罷	ㄍㄨㄢ　ㄅㄚˋ
巴里島	ㄅㄚ　ㄌ｜ˇ　ㄉㄠˇ
燕樂二十八調	｜ㄢˋ　ㄩㄝˋ　ㄦˋ　ㄕˊ　ㄅㄚ　ㄉ｜ㄠˋ
巴達桑	ㄅㄚ　ㄉㄚˊ　ㄙㄤ
提口拔舌	ㄊ｜ˊ　ㄎㄡˇ　ㄅㄚˊ　ㄕㄜˊ
巴謾	ㄅㄚ　ㄇㄢˋ
九牛身上拔一根毛	ㄐ｜ㄡˇ　ㄋ｜ㄡˊ　ㄕㄣ　ㄕㄤˋ　ㄅㄚˊ　｜　ㄍㄣ　ㄇㄠˊ
巴都兒	ㄅㄚ　ㄉㄨ　ㄦˊ
糌粑	ㄗㄢˊ　ㄅㄚ
拔碇	ㄅㄚˊ　ㄉ｜ㄥˋ
孤拔	ㄍㄨ　ㄅㄚˊ
光板兒	ㄍㄨㄤ　ㄅㄢˇㄦ　(變)ㄍㄨㄤ　ㄅㄚˇㄦ
拔腿	ㄅㄚˊ　ㄊㄨㄟˇ
八字眉	ㄅㄚ　ㄗˋ　ㄇㄟˊ
二把刀	ㄦˋ　ㄅㄚˇ　ㄉㄠ
抽筋拔骨	ㄔㄡ　ㄐ｜ㄣ　ㄅㄚˊ　ㄍㄨˇ
溫八叉	ㄨㄣ　ㄅㄚ　ㄔㄚ
不把人看在眼裡	ㄅㄨˋ　ㄅㄚˇ　ㄖㄣˊ　ㄎㄢˋ　ㄗㄞˋ　｜ㄢˇ　ㄌ｜ˇ
拉巴斯	ㄌㄚ　ㄅㄚ　ㄙ
把猾	ㄅㄚˇ　ㄏㄨㄚˊ
掤扒吊栲	ㄅ｜ㄥ　ㄅㄚ　ㄉ｜ㄠˋ　ㄎㄠˇ
巴勒斯坦	ㄅㄚ　ㄌㄜˋ　ㄙ　ㄊㄢˇ
八卦教	ㄅㄚ　ㄍㄨㄚˋ　ㄐ｜ㄠˋ
八風吹不動	ㄅㄚ　ㄈㄥ　ㄔㄨㄟ　ㄅㄨˋ　ㄉㄨㄥˋ
老天拔地	ㄌㄠˇ　ㄊ｜ㄢ　ㄅㄚˊ　ㄉ｜ˋ
把錢	ㄅㄚˇ　ㄑ｜ㄢˊ
龐巴度夫人	ㄆㄤˊ　ㄅㄚ　ㄉㄨˋ　ㄈㄨ　ㄖㄣˊ
扯牛尾巴	ㄔㄜˇ　ㄋ｜ㄡˊ　ㄨㄟˇ　˙ㄅㄚ
芭蒂	ㄅㄚ　ㄉ｜ˋ
醜巴怪	ㄔㄡˇ　ㄅㄚ　ㄍㄨㄞˋ
跋前躓後	ㄅㄚˊ　ㄑ｜ㄢˊ　ㄓˋ　ㄏㄡˋ
路見不平，拔劍相助	ㄌㄨˋ　ㄐ｜ㄢˋ　ㄅㄨˋ　ㄆ｜ㄥˊ　ㄅㄚˊ　ㄐ｜ㄢˋ　ㄒ｜ㄤ　ㄓㄨˋ
八角蓮	ㄅㄚ　ㄐ｜ㄠˇ　ㄌ｜ㄢˊ
阿巴丹	ㄚ　ㄅㄚ　ㄉㄢ
各霸一方	ㄍㄜˋ　ㄅㄚˋ　｜　ㄈㄤ
把卷	ㄅㄚˇ　ㄐㄩㄢˋ
巴河	ㄅㄚ　ㄏㄜˊ
大巴山	ㄉㄚˋ　ㄅㄚ　ㄕㄢ
草把	ㄘㄠˇ　ㄅㄚˇ
罷駛	ㄅㄚˋ　ㄕˇ
拔刀相濟	ㄅㄚˊ　ㄉㄠ　ㄒ｜ㄤ　ㄐ｜ˋ
巴江	ㄅㄚ　ㄐ｜ㄤ
八答麻鞋	ㄅㄚ　ㄉㄚ　ㄇㄚˊ　ㄒ｜ㄝˊ
巴拿馬	ㄅㄚ　ㄋㄚˊ　ㄇㄚˇ
搭七搭八	ㄉㄚ　ㄑ｜　ㄉㄚ　ㄅㄚ
八竿子打不著	ㄅㄚ　ㄍㄢ　˙ㄗ　ㄉㄚˇ　ㄅㄨˋ　ㄓㄠˊ
鋼琴酒吧	ㄍㄤ　ㄑ｜ㄣˊ　ㄐ｜ㄡˇ　ㄅㄚ
拔山曲	ㄅㄚˊ　ㄕㄢ　ㄑㄩˇ
巴豆	ㄅㄚ　ㄉㄡˋ
淋巴管	ㄌ｜ㄣˊ　ㄅㄚ　ㄍㄨㄢˇ
霸權	ㄅㄚˋ　ㄑㄩㄢˊ
巴特農神殿	ㄅㄚ　ㄊㄜˋ　ㄋㄨㄥˊ　ㄕㄣˊ　ㄉ｜ㄢˋ
靠把	ㄎㄠˋ　ㄅㄚˇ
巴斯德	ㄅㄚ　ㄙ　ㄉㄜˊ
軷涉	ㄅㄚˊ　ㄕㄜˋ
把玩	ㄅㄚˇ　ㄨㄢˋ
獨霸一方	ㄉㄨˊ　ㄅㄚˋ　｜　ㄈㄤ
巴爾陶克	ㄅㄚ　ㄦˇ　ㄊㄠˊ　ㄎㄜˋ
胈	ㄅㄚˊ
打把式	ㄉㄚˇ　ㄅㄚˇ　˙ㄕ
空中巴士	ㄎㄨㄥ　ㄓㄨㄥ　ㄅㄚ　ㄕˋ
拔群	ㄅㄚˊ　ㄑㄩㄣˊ
四方八面	ㄙˋ　ㄈㄤ　ㄅㄚ　ㄇ｜ㄢˋ
巴水	ㄅㄚ　ㄕㄨㄟˇ
古巴危機	ㄍㄨˇ　ㄅㄚ　ㄨㄟˊ　ㄐ｜
八兩半斤	ㄅㄚ　ㄌ｜ㄤˇ　ㄅㄢˋ　ㄐ｜ㄣ
十八的姑娘一朵花	ㄕˊ　ㄅㄚ　˙ㄉㄜ　ㄍㄨ　ㄋ｜ㄤˊ　｜　ㄉㄨㄛˇ　ㄏㄨㄚ
淋巴節	ㄌ｜ㄣˊ　ㄅㄚ　ㄐ｜ㄝˊ
把口	ㄅㄚˇ　ㄎㄡˇ
心字頭上一把刀	ㄒ｜ㄣ　ㄗˋ　ㄊㄡˊ　ㄕㄤˋ　｜　ㄅㄚˇ　ㄉㄠ
沒巴臂	ㄇㄟˊ　ㄅㄚ　ㄅ｜ˋ
拔了蘿蔔地皮寬	ㄅㄚˊ　˙ㄌㄜ　ㄌㄨㄛˊ　˙ㄅㄛ　ㄉ｜ˋ　ㄆ｜ˊ　ㄎㄨㄢ
大八成	ㄉㄚˋ　ㄅㄚ　ㄔㄥˊ
拔刀斷席	ㄅㄚˊ　ㄉㄠ　ㄉㄨㄢˋ　ㄒ｜ˊ
拔幟	ㄅㄚˊ　ㄓˋ
跋涉	ㄅㄚˊ　ㄕㄜˋ
掌把	ㄓㄤˇ　ㄅㄚˇ
扯尾巴	ㄔㄜˇ　ㄨㄟˇ　˙ㄅㄚ
瘦筋巴骨	ㄕㄡˋ　ㄐ｜ㄣ　ㄅㄚ　ㄍㄨˇ
不說話，沒人當你是啞吧	ㄅㄨˋ　ㄕㄨㄛ　ㄏㄨㄚˋ　ㄇㄟˊ　ㄖㄣˊ　ㄉㄤˋ　ㄋ｜ˇ　ㄕˋ　｜ㄚˇ　˙ㄅㄚ
二十八調	ㄦˋ　ㄕˊ　ㄅㄚ　ㄉ｜ㄠˋ
八旗都統	ㄅㄚ　ㄑ｜ˊ　ㄉㄨ　ㄊㄨㄥˇ
巴基斯坦伊斯蘭共和國	ㄅㄚ　ㄐ｜　ㄙ　ㄊㄢˇ　｜　ㄙ　ㄌㄢˊ　ㄍㄨㄥˋ　ㄏㄜˊ　ㄍㄨㄛˊ
拔縫	ㄅㄚˊ　ㄈㄥˋ
生辰八字	ㄕㄥ　ㄔㄣˊ　ㄅㄚ　ㄗˋ
雜拌兒	ㄗㄚˊ　ㄅㄢˋㄦ　(變)ㄗㄚˊ　ㄅㄚˋㄦ
輈張跋扈	ㄓㄡ　ㄓㄤ　ㄅㄚˊ　ㄏㄨˋ
拔幟易幟	ㄅㄚˊ　ㄓˋ　｜ˋ　ㄓˋ
評跋	ㄆ｜ㄥˊ　ㄅㄚˊ
爭霸	ㄓㄥ　ㄅㄚˋ
把牢	ㄅㄚˇ　ㄌㄠˊ
八色鳥	ㄅㄚ　ㄙㄜˋ　ㄋ｜ㄠˇ
下板兒	ㄒ｜ㄚˋ　ㄅㄢˇㄦ　(變)ㄒ｜ㄚˋ　ㄅㄚˇㄦ
芭蕉	ㄅㄚ　ㄐ｜ㄠ
點把	ㄉ｜ㄢˇ　ㄅㄚˇ
八面威風	ㄅㄚ　ㄇ｜ㄢˋ　ㄨㄟ　ㄈㄥ
東野巴人	ㄉㄨㄥ　｜ㄝˇ　ㄅㄚ　ㄖㄣˊ
八面圓通	ㄅㄚ　ㄇ｜ㄢˋ　ㄩㄢˊ　ㄊㄨㄥ
巴人下里	ㄅㄚ　ㄖㄣˊ　ㄒ｜ㄚˋ　ㄌ｜ˇ
八言詩	ㄅㄚ　｜ㄢˊ　ㄕ
八輩子	ㄅㄚ　ㄅㄟˋ　˙ㄗ
七橫八豎	ㄑ｜　ㄏㄥˊ　ㄅㄚ　ㄕㄨˋ
滿把	ㄇㄢˇ　ㄅㄚˇ
一把屎，一把尿	｜　ㄅㄚˇ　ㄕˇ　｜　ㄅㄚˇ　ㄋ｜ㄠˋ
頭把兒	ㄊㄡˊ　ㄅㄚˋㄦ
八識	ㄅㄚ　ㄕˋ
亞斯文高壩	｜ㄚˋ　ㄙ　ㄨㄣˊ　ㄍㄠ　ㄅㄚˋ
把門人	ㄅㄚˇ　ㄇㄣˊ　ㄖㄣˊ
矮巴溜丟	ㄞˇ　ㄅㄚ　ㄌ｜ㄡ　ㄉ｜ㄡ
八角楓科	ㄅㄚ　ㄐ｜ㄠˇ　ㄈㄥ　ㄎㄜ
八議	ㄅㄚ　｜ˋ
霸機	ㄅㄚˋ　ㄐ｜
罷	ㄅㄚˋ,˙ㄅㄚ
自拔來歸	ㄗˋ　ㄅㄚˊ　ㄌㄞˊ　ㄍㄨㄟ
捏過印把子的	ㄋ｜ㄝ　ㄍㄨㄛˋ　｜ㄣˋ　ㄅㄚˇ　˙ㄗ　˙ㄉㄜ
把勢	ㄅㄚˇ　˙ㄕ
一班兒	｜　ㄅㄢㄦ　(變)｜ˋ　ㄅㄚㄦ
拔絲	ㄅㄚˊ　ㄙ
老把式	ㄌㄠˇ　ㄅㄚˇ　˙ㄕ
把手言歡	ㄅㄚˇ　ㄕㄡˇ　｜ㄢˊ　ㄏㄨㄢ
巴貝多	ㄅㄚ　ㄅㄟˋ　ㄉㄨㄛ
巴東	ㄅㄚ　ㄉㄨㄥ
八病九痛	ㄅㄚ　ㄅ｜ㄥˋ　ㄐ｜ㄡˇ　ㄊㄨㄥˋ
痘疤	ㄉㄡˋ　ㄅㄚ
緊七慢八	ㄐ｜ㄣˇ　ㄑ｜　ㄇㄢˋ　ㄅㄚ
正經八百	ㄓㄥˋ　˙ㄐ｜ㄥ　ㄅㄚ　ㄅㄞˇ
把風	ㄅㄚˇ　ㄈㄥ
疤痕	ㄅㄚ　ㄏㄣˊ
罷官	ㄅㄚˋ　ㄍㄨㄢ
長途跋涉	ㄔㄤˊ　ㄊㄨˊ　ㄅㄚˊ　ㄕㄜˋ
忽剌巴	ㄏㄨ　ㄌㄚˋ　ㄅㄚ
拔得頭籌	ㄅㄚˊ　ㄉㄜˊ　ㄊㄡˊ　ㄔㄡˊ
把兒	ㄅㄚˇㄦ
八裔	ㄅㄚ　｜ˋ
八國聯軍	ㄅㄚ　ㄍㄨㄛˊ　ㄌ｜ㄢˊ　ㄐㄩㄣ
八愷	ㄅㄚ　ㄎㄞˇ
巴人	ㄅㄚ　ㄖㄣˊ
救拔	ㄐ｜ㄡˋ　ㄅㄚˊ
八字打開	ㄅㄚ　ㄗˋ　ㄉㄚˇ　ㄎㄞ
巴金森氏症	ㄅㄚ　ㄐ｜ㄣ　ㄙㄣ　ㄕˋ　ㄓㄥˋ
甜八寶	ㄊ｜ㄢˊ　ㄅㄚ　ㄅㄠˇ
八般大禮	ㄅㄚ　ㄅㄢ　ㄉㄚˋ　ㄌ｜ˇ
腌裡巴臢	ㄤ　˙ㄌ｜　ㄅㄚ　ㄗㄤ
二二八紀念碑	ㄦˋ　ㄦˋ　ㄅㄚ　ㄐ｜ˋ　ㄋ｜ㄢˋ　ㄅㄟ
八兩配半斤	ㄅㄚ　ㄌ｜ㄤˇ　ㄆㄟˋ　ㄅㄢˋ　ㄐ｜ㄣ
五花八門	ㄨˇ　ㄏㄨㄚ　ㄅㄚ　ㄇㄣˊ
吧	ㄅㄚ,˙ㄅㄚ
巴枯寧主義	ㄅㄚ　ㄎㄨ　ㄋ｜ㄥˊ　ㄓㄨˇ　｜ˋ
拔頭籌	ㄅㄚˊ　ㄊㄡˊ　ㄔㄡˊ
迥拔	ㄐㄩㄥˇ　ㄅㄚˊ
巴爾定	ㄅㄚ　ㄦˇ　ㄉ｜ㄥˋ
巴丘	ㄅㄚ　ㄑ｜ㄡ
霸業	ㄅㄚˋ　｜ㄝˋ
巴拿馬市	ㄅㄚ　ㄋㄚˊ　ㄇㄚˇ　ㄕˋ
鐵將軍把門	ㄊ｜ㄝˇ　ㄐ｜ㄤ　ㄐㄩㄣ　ㄅㄚˇ　ㄇㄣˊ
八行	ㄅㄚ　ㄏㄤˊ
勁拔	ㄐ｜ㄥˋ　ㄅㄚˊ
瞎說八道	ㄒ｜ㄚ　ㄕㄨㄛ　ㄅㄚ　ㄉㄠˋ
滿有把握	ㄇㄢˇ　｜ㄡˇ　ㄅㄚˇ　ㄨㄛˋ
八風吹不倒	ㄅㄚ　ㄈㄥ　ㄔㄨㄟ　ㄅㄨˋ　ㄉㄠˇ
毫巴	ㄏㄠˊ　ㄅㄚ
獨霸	ㄉㄨˊ　ㄅㄚˋ
葛天八闋	ㄍㄜˇ　ㄊ｜ㄢ　ㄅㄚ　ㄑㄩㄝˋ
四平八穩	ㄙˋ　ㄆ｜ㄥˊ　ㄅㄚ　ㄨㄣˇ
沒把鼻	ㄇㄟˊ　ㄅㄚˇ　ㄅ｜ˊ
八二三炮戰	ㄅㄚ　ㄦˋ　ㄙㄢ　ㄆㄠˋ　ㄓㄢˋ
十萬八千里	ㄕˊ　ㄨㄢˋ　ㄅㄚ　ㄑ｜ㄢ　ㄌ｜ˇ
拔本塞源	ㄅㄚˊ　ㄅㄣˇ　ㄙㄜˋ　ㄩㄢˊ
巴安縣	ㄅㄚ　ㄢ　ㄒ｜ㄢˋ
八思巴	ㄅㄚ　ㄙ　ㄅㄚ
瓢把子	ㄆ｜ㄠˊ　ㄅㄚˇ　˙ㄗ
巴頭探腦	ㄅㄚ　ㄊㄡˊ　ㄊㄢˋ　ㄋㄠˇ
四雙八輩	ㄙˋ　ㄕㄨㄤ　ㄅㄚ　ㄅㄟˋ
倫巴	ㄌㄨㄣˊ　ㄅㄚ
把做	ㄅㄚˇ　ㄗㄨㄛˋ
一九九五閏八月	｜　ㄐ｜ㄡˇ　ㄐ｜ㄡˇ　ㄨˇ　ㄖㄨㄣˋ　ㄅㄚ　ㄩㄝˋ
嘎巴流星	ㄍㄚ　˙ㄅㄚ　ㄌ｜ㄡˊ　ㄒ｜ㄥ
仰八腳兒	｜ㄤˇ　˙ㄅㄚ　ㄐ｜ㄠˇㄦ
八角	ㄅㄚ　ㄐ｜ㄠˇ
一巴掌	｜　ㄅㄚ　ㄓㄤˇ
巴子拳	ㄅㄚ　ㄗˇ　ㄑㄩㄢˊ
古巴	ㄍㄨˇ　ㄅㄚ
八家將	ㄅㄚ　ㄐ｜ㄚ　ㄐ｜ㄤˋ
拔尖	ㄅㄚˊ　ㄐ｜ㄢ
唐宋古文八大家	ㄊㄤˊ　ㄙㄨㄥˋ　ㄍㄨˇ　ㄨㄣˊ　ㄅㄚ　ㄉㄚˋ　ㄐ｜ㄚ
一把罩	｜　ㄅㄚˇ　ㄓㄠˋ
巴黎畫派	ㄅㄚ　ㄌ｜ˊ　ㄏㄨㄚˋ　ㄆㄞˋ
赤巴巴	ㄔˋ　ㄅㄚ　˙ㄅㄚ
灞陵尉	ㄅㄚˋ　ㄌ｜ㄥˊ　ㄨㄟˋ
拖把	ㄊㄨㄛ　ㄅㄚˇ
氧吧	｜ㄤˇ　ㄅㄚ
八門五花	ㄅㄚ　ㄇㄣˊ　ㄨˇ　ㄏㄨㄚ
伯業	ㄅㄚˋ　｜ㄝˋ
八字都沒一撇	ㄅㄚ　ㄗˋ　ㄉㄡ　ㄇㄟˊ　｜　ㄆ｜ㄝˇ
三八	ㄙㄢ　ㄅㄚ
八段錦	ㄅㄚ　ㄉㄨㄢˋ　ㄐ｜ㄣˇ
專橫跋扈	ㄓㄨㄢ　ㄏㄥˋ　ㄅㄚˊ　ㄏㄨˋ
風流話靶	ㄈㄥ　ㄌ｜ㄡˊ　ㄏㄨㄚˋ　ㄅㄚˇ
拔山舉鼎	ㄅㄚˊ　ㄕㄢ　ㄐㄩˇ　ㄉ｜ㄥˇ
八大家	ㄅㄚ　ㄉㄚˋ　ㄐ｜ㄚ
七言八語	ㄑ｜　｜ㄢˊ　ㄅㄚ　ㄩˇ
臘八粥	ㄌㄚˋ　ㄅㄚ　ㄓㄡ
醜八怪	ㄔㄡˇ　ㄅㄚ　ㄍㄨㄞˋ
阿米巴	ㄚ　ㄇ｜ˇ　ㄅㄚ
做尾巴	ㄗㄨㄛˋ　ㄨㄟˇ　˙ㄅㄚ
拉巴	ㄌㄚ　˙ㄅㄚ
八極	ㄅㄚ　ㄐ｜ˊ
霸術	ㄅㄚˋ　ㄕㄨˋ
巴漢	ㄅㄚ　ㄏㄢˋ
罷斥	ㄅㄚˋ　ㄔˋ
淋巴	ㄌ｜ㄣˊ　ㄅㄚ
巴烏	ㄅㄚ　ㄨ
把似	ㄅㄚˇ　ㄙˋ
巴茲卡	ㄅㄚ　ㄗ　ㄎㄚˇ
巴圖魯坎肩	ㄅㄚ　ㄊㄨˊ　ㄌㄨˇ　ㄎㄢˇ　ㄐ｜ㄢ
把不住	ㄅㄚˇ　ㄅㄨˋ　ㄓㄨˋ
把作	ㄅㄚˇ　ㄗㄨㄛˋ
鬼打鈸	ㄍㄨㄟˇ　ㄉㄚˇ　ㄅㄚˊ
把位	ㄅㄚˇ　ㄨㄟˋ
把住	ㄅㄚˇ　ㄓㄨˋ
老鼠尾巴生瘡兒	ㄌㄠˇ　ㄕㄨˇ　ㄨㄟˇ　˙ㄅㄚ　ㄕㄥ　ㄔㄨㄤㄦ
八水三川	ㄅㄚ　ㄕㄨㄟˇ　ㄙㄢ　ㄔㄨㄢ
八難	ㄅㄚ　ㄋㄢˊ
巴比倫空中花園	ㄅㄚ　ㄅ｜ˇ　ㄌㄨㄣˊ　ㄎㄨㄥ　ㄓㄨㄥ　ㄏㄨㄚ　ㄩㄢˊ
洛巴	ㄌㄨㄛˋ　ㄅㄚ
嘴巴子	ㄗㄨㄟˇ　˙ㄅㄚ　˙ㄗ
叭	ㄅㄚ
鎗靶	ㄑ｜ㄤ　ㄅㄚˇ
八大山人	ㄅㄚ　ㄉㄚˋ　ㄕㄢ　ㄖㄣˊ
八王日	ㄅㄚ　ㄨㄤˊ　ㄖˋ
八相	ㄅㄚ　ㄒ｜ㄤˋ
標靶	ㄅ｜ㄠ　ㄅㄚˇ
扒頭兒	ㄅㄚ　˙ㄊㄡㄦ
王八	ㄨㄤˊ　˙ㄅㄚ
罷收	ㄅㄚˋ　ㄕㄡ
持齋把素	ㄔˊ　ㄓㄞ　ㄅㄚˇ　ㄙㄨˋ
巴哈馬	ㄅㄚ　ㄏㄚ　ㄇㄚˇ
批八字	ㄆ｜　ㄅㄚ　ㄗˋ
巴夫洛夫	ㄅㄚ　ㄈㄨ　ㄌㄨㄛˋ　ㄈㄨ
八面玲瓏	ㄅㄚ　ㄇ｜ㄢˋ　ㄌ｜ㄥˊ　ㄌㄨㄥˊ
七老八十	ㄑ｜　ㄌㄠˇ　ㄅㄚ　ㄕˊ
出把戲	ㄔㄨ　ㄅㄚˇ　ㄒ｜ˋ
振拔	ㄓㄣˋ　ㄅㄚˊ
堅忍不拔	ㄐ｜ㄢ　ㄖㄣˇ　ㄅㄨˋ　ㄅㄚˊ
愣眼巴睜	ㄌㄥˋ　｜ㄢˇ　ㄅㄚ　ㄓㄥ
霸圖	ㄅㄚˋ　ㄊㄨˊ
八寶	ㄅㄚ　ㄅㄠˇ
巴爾幹半島	ㄅㄚ　ㄦˇ　ㄍㄢˋ　ㄅㄢˋ　ㄉㄠˇ
拉拔	ㄌㄚ　˙ㄅㄚ
盈把	｜ㄥˊ　ㄅㄚˇ
八仙桌上擺夜壺	ㄅㄚ　ㄒ｜ㄢ　ㄓㄨㄛ　ㄕㄤˋ　ㄅㄞˇ　｜ㄝˋ　ㄏㄨˊ
畢罷	ㄅ｜ˋ　ㄅㄚˋ
馬林巴琴	ㄇㄚˇ　ㄌ｜ㄣˊ　ㄅㄚ　ㄑ｜ㄣˊ
巴陵郡	ㄅㄚ　ㄌ｜ㄥˊ　ㄐㄩㄣˋ
八陣	ㄅㄚ　ㄓㄣˋ
八拜交	ㄅㄚ　ㄅㄞˋ　ㄐ｜ㄠ
巴塔哥尼亞高原	ㄅㄚ　ㄊㄚˇ　ㄍㄜ　ㄋ｜ˊ　｜ㄚˋ　ㄍㄠ　ㄩㄢˊ
罷教	ㄅㄚˋ　ㄐ｜ㄠ
拔刀相助	ㄅㄚˊ　ㄉㄠ　ㄒ｜ㄤ　ㄓㄨˋ
巴金	ㄅㄚ　ㄐ｜ㄣ
八垓	ㄅㄚ　ㄍㄞ
出家人吃八方	ㄔㄨ　ㄐ｜ㄚ　ㄖㄣˊ　ㄔ　ㄅㄚ　ㄈㄤ
把下	ㄅㄚˇ　ㄒ｜ㄚˋ
八垠	ㄅㄚ　｜ㄣˊ
葛巴丁	ㄍㄜˊ　ㄅㄚ　ㄉ｜ㄥ
巴拿馬共和國	ㄅㄚ　ㄋㄚˊ　ㄇㄚˇ　ㄍㄨㄥˋ　ㄏㄜˊ　ㄍㄨㄛˊ
巴士	ㄅㄚ　ㄕˋ
把	ㄅㄚˇ,ㄅㄚˋ
小把戲	ㄒ｜ㄠˇ　ㄅㄚˇ　ㄒ｜ˋ
八怪七喇	ㄅㄚ　ㄍㄨㄞˋ　ㄑ｜　ㄌㄚˇ
黜罷	ㄔㄨˋ　ㄅㄚˋ
捌格	ㄅㄚ　ㄍㄜˊ
八埏	ㄅㄚ　｜ㄢˊ
捌	ㄅㄚ
豬八戒戴花	ㄓㄨ　ㄅㄚ　ㄐ｜ㄝˋ　ㄉㄞˋ　ㄏㄨㄚ
峭拔	ㄑ｜ㄠˋ　ㄅㄚˊ
稱王稱霸	ㄔㄥ　ㄨㄤˊ　ㄔㄥ　ㄅㄚˋ
眉分八彩	ㄇㄟˊ　ㄈㄣ　ㄅㄚ　ㄘㄞˇ
歐巴桑	ㄡ　˙ㄅㄚ　ㄙㄤ
內八字腳	ㄋㄟˋ　ㄅㄚ　ㄗˋ　ㄐ｜ㄠˇ
曹霸	ㄘㄠˊ　ㄅㄚˋ
巴雷利	ㄅㄚ　ㄌㄟˊ　ㄌ｜ˋ
八石	ㄅㄚ　ㄕˊ
豬八戒	ㄓㄨ　ㄅㄚ　ㄐ｜ㄝˋ
五伯	ㄨˇ　ㄅㄚˋ
巴夏禮	ㄅㄚ　ㄒ｜ㄚˋ　ㄌ｜ˇ
巴先	ㄅㄚ　ㄒ｜ㄢ
帶把子	ㄉㄞˋ　ㄅㄚˇ　˙ㄗ
哈巴	ㄏㄚˇ　˙ㄅㄚ
拿把	ㄋㄚˊ　ㄅㄚˇ
小霸王	ㄒ｜ㄠˇ　ㄅㄚˋ　ㄨㄤˊ
巴勒摩	ㄅㄚ　ㄌㄜˋ　ㄇㄛˊ
巴斯克人	ㄅㄚ　ㄙ　ㄎㄜˋ　ㄖㄣˊ
濟貧拔苦	ㄐ｜ˋ　ㄆ｜ㄣˊ　ㄅㄚˊ　ㄎㄨˇ
把滑	ㄅㄚˇ　ㄏㄨㄚˊ
嘴把式	ㄗㄨㄟˇ　ㄅㄚˇ　˙ㄕ
拔宅飛昇	ㄅㄚˊ　ㄓㄞˊ　ㄈㄟ　ㄕㄥ
伯圖	ㄅㄚˋ　ㄊㄨˊ
八	ㄅㄚ
豬八戒坐飛機	ㄓㄨ　ㄅㄚ　ㄐ｜ㄝˋ　ㄗㄨㄛˋ　ㄈㄟ　ㄐ｜
阿爾巴尼亞	ㄚ　ㄦˇ　ㄅㄚ　ㄋ｜ˊ　｜ㄚˋ
簡拔	ㄐ｜ㄢˇ　ㄅㄚˊ
芭蕉科	ㄅㄚ　ㄐ｜ㄠ　ㄎㄜ
鈀	ㄅㄚ,ㄅㄚˇ
巴拉松	ㄅㄚ　ㄌㄚ　ㄙㄨㄥ
笆	ㄅㄚ
八字宮眉	ㄅㄚ　ㄗˋ　ㄍㄨㄥ　ㄇㄟˊ
把臂而談	ㄅㄚˇ　ㄅ｜ˋ　ㄦˊ　ㄊㄢˊ
灞陵縣	ㄅㄚˋ　ㄌ｜ㄥˊ　ㄒ｜ㄢˋ
拔本塞原	ㄅㄚˊ　ㄅㄣˇ　ㄙㄜˋ　ㄩㄢˊ
巴鏝	ㄅㄚ　ㄇㄢˋ
巴士底監獄	ㄅㄚ　ㄕˋ　ㄉ｜ˇ　ㄐ｜ㄢ　ㄩˋ
第一把交椅	ㄉ｜ˋ　｜　ㄅㄚˇ　ㄐ｜ㄠ　｜ˇ
二八佳人	ㄦˋ　ㄅㄚ　ㄐ｜ㄚ　ㄖㄣˊ
攔洪壩	ㄌㄢˊ　ㄏㄨㄥˊ　ㄅㄚˋ
楚霸王	ㄔㄨˇ　ㄅㄚˋ　ㄨㄤˊ
拔樹尋根	ㄅㄚˊ　ㄕㄨˋ　ㄒㄩㄣˊ　ㄍㄣ
八人轎	ㄅㄚ　ㄖㄣˊ　ㄐ｜ㄠˋ
巴赫	ㄅㄚ　ㄏㄜˋ
巴力	ㄅㄚ　ㄌ｜ˋ
王八辮兒	ㄨㄤˊ　˙ㄅㄚ　ㄅ｜ㄢˋㄦ　(變)ㄨㄤˊ　˙ㄅㄚ　ㄅ｜ㄚˋㄦ
不如意事，十常八九	ㄅㄨˋ　ㄖㄨˊ　｜ˋ　ㄕˋ　ㄕˊ　ㄔㄤˊ　ㄅㄚ　ㄐ｜ㄡˇ
一把手	｜　ㄅㄚˇ　ㄕㄡˇ
欺行霸市	ㄑ｜　ㄏㄤˊ　ㄅㄚˋ　ㄕˋ
八哥	ㄅㄚ　ㄍㄜ
巴顏喀喇山	ㄅㄚ　｜ㄢˊ　ㄎㄚˋ　ㄌㄚˇ　ㄕㄢ
巴劫	ㄅㄚ　˙ㄐ｜ㄝ
花把戲	ㄏㄨㄚ　ㄅㄚˇ　ㄒ｜ˋ
威震八方	ㄨㄟ　ㄓㄣˋ　ㄅㄚ　ㄈㄤ
一把抓	｜　ㄅㄚˇ　ㄓㄨㄚ
巴剎	ㄅㄚ　ㄔㄚˋ
空中芭蕾	ㄎㄨㄥ　ㄓㄨㄥ　ㄅㄚ　ㄌㄟˇ
喇叭褲	ㄌㄚˇ　˙ㄅㄚ　ㄎㄨˋ
巴里斯	ㄅㄚ　ㄌ｜ˇ　ㄙ
雜霸	ㄗㄚˊ　ㄅㄚˋ
黃霸	ㄏㄨㄤˊ　ㄅㄚˋ
脫靶	ㄊㄨㄛ　ㄅㄚˇ
兩把刷子	ㄌ｜ㄤˇ　ㄅㄚˇ　ㄕㄨㄚ　˙ㄗ
門鈸	ㄇㄣˊ　ㄅㄚˊ
稀巴爛	ㄒ｜　ㄅㄚ　ㄌㄢˋ
瀟湘八景	ㄒ｜ㄠ　ㄒ｜ㄤ　ㄅㄚ　ㄐ｜ㄥˇ
尾巴	ㄨㄟˇ　˙ㄅㄚ
霸略	ㄅㄚˋ　ㄌㄩㄝˋ
巴菽	ㄅㄚ　ㄕㄨˊ
巴爾	ㄅㄚ　ㄦˇ
劍拔弩張	ㄐ｜ㄢˋ　ㄅㄚˊ　ㄋㄨˇ　ㄓㄤ
巴到	ㄅㄚ　ㄉㄠˋ
巴利	ㄅㄚ　ㄌ｜ˋ
巴爾貝里尼宮殿	ㄅㄚ　ㄦˇ　ㄅㄟˋ　ㄌ｜ˇ　ㄋ｜ˊ　ㄍㄨㄥ　ㄉ｜ㄢˋ
灞陵醉尉	ㄅㄚˋ　ㄌ｜ㄥˊ　ㄗㄨㄟˋ　ㄨㄟˋ
八門	ㄅㄚ　ㄇㄣˊ
七損八傷	ㄑ｜　ㄙㄨㄣˇ　ㄅㄚ　ㄕㄤ
巴爾的摩	ㄅㄚ　ㄦˇ　ㄉ｜ˋ　ㄇㄛˊ
盲人把燭	ㄇㄤˊ　ㄖㄣˊ　ㄅㄚˇ　ㄓㄨˊ
巨無霸	ㄐㄩˋ　ㄨˊ　ㄅㄚˋ
老把戲	ㄌㄠˇ　ㄅㄚˇ　ㄒ｜ˋ
才儲八斗	ㄘㄞˊ　ㄔㄨˊ　ㄅㄚ　ㄉㄡˇ
八病	ㄅㄚ　ㄅ｜ㄥˋ
八位元個人電腦	ㄅㄚ　ㄨㄟˋ　ㄩㄢˊ　ㄍㄜˋ　ㄖㄣˊ　ㄉ｜ㄢˋ　ㄋㄠˇ
士巴拿	ㄕˋ　ㄅㄚ　ㄋㄚˊ
金陵八家	ㄐ｜ㄣ　ㄌ｜ㄥˊ　ㄅㄚ　ㄐ｜ㄚ
秦書八體	ㄑ｜ㄣˊ　ㄕㄨ　ㄅㄚ　ㄊ｜ˇ
七除八扣	ㄑ｜　ㄔㄨˊ　ㄅㄚ　ㄎㄡˋ
八會穴	ㄅㄚ　ㄏㄨㄟˋ　ㄒㄩㄝˋ
四通八達	ㄙˋ　ㄊㄨㄥ　ㄅㄚ　ㄉㄚˊ
白花八角	ㄅㄞˊ　ㄏㄨㄚ　ㄅㄚ　ㄐ｜ㄠˇ
八斗之才	ㄅㄚ　ㄉㄡˇ　ㄓ　ㄘㄞˊ
四仰八叉	ㄙˋ　｜ㄤˇ　ㄅㄚ　ㄔㄚ
天下不如意事，十常八九	ㄊ｜ㄢ　ㄒ｜ㄚˋ　ㄅㄨˋ　ㄖㄨˊ　｜ˋ　ㄕˋ　ㄕˊ　ㄔㄤˊ　ㄅㄚ　ㄐ｜ㄡˇ
拉一把	ㄌㄚ　｜　ㄅㄚˇ
巴朗孜闊木	ㄅㄚ　ㄌㄤˇ　ㄗ　ㄎㄨㄛˋ　ㄇㄨˋ
歪七扭八	ㄨㄞ　ㄑ｜　ㄋ｜ㄡˇ　ㄅㄚ
抓一把	ㄓㄨㄚ　｜　ㄅㄚˇ
小打扮兒	ㄒ｜ㄠˇ　ㄉㄚˇ　ㄅㄢˋㄦ　(變)ㄒ｜ㄠˇ　ㄉㄚˇ　ㄅㄚˋㄦ
八字全帖	ㄅㄚ　ㄗˋ　ㄑㄩㄢˊ　ㄊ｜ㄝˇ
攢拌兒	ㄘㄨㄢˊ　ㄅㄢˋㄦ　(變)ㄘㄨㄢˊ　ㄅㄚˋㄦ
中巴	ㄓㄨㄥ　ㄅㄚ
掤扒	ㄅ｜ㄥ　ㄅㄚ
趿拉板兒	ㄊㄚ　˙ㄌㄚ　ㄅㄢˇㄦ　(變)ㄊㄚ　˙ㄌㄚ　ㄅㄚˇㄦ
巴拉圭河	ㄅㄚ　ㄌㄚ　ㄍㄨㄟ　ㄏㄜˊ
攔沙壩	ㄌㄢˊ　ㄕㄚ　ㄅㄚˋ
連根拔掉	ㄌ｜ㄢˊ　ㄍㄣ　ㄅㄚˊ　ㄉ｜ㄠˋ
八瓣兒五	ㄅㄚ　ㄅㄢˋㄦ　ㄨˇ　(變)ㄅㄚˊ　ㄅㄚˋㄦ　ㄨˇ
威風八面	ㄨㄟ　ㄈㄥ　ㄅㄚ　ㄇ｜ㄢˋ
下巴頦	ㄒ｜ㄚˋ　˙ㄅㄚ　ㄎㄜ
行家莫說力把話	ㄏㄤˊ　˙ㄐ｜ㄚ　ㄇㄛˋ　ㄕㄨㄛ　ㄌ｜ˋ　˙ㄅㄚ　ㄏㄨㄚˋ
十八九	ㄕˊ　ㄅㄚ　ㄐ｜ㄡˇ
巴拉馬利波市	ㄅㄚ　ㄌㄚ　ㄇㄚˇ　ㄌ｜ˋ　ㄅㄛ　ㄕˋ
巴	ㄅㄚ
沒巴鼻	ㄇㄟˊ　ㄅㄚ　ㄅ｜ˊ
把賣	ㄅㄚˇ　ㄇㄞˋ
翹尾巴	ㄑ｜ㄠˋ　｜ˇ　ㄅㄚ
八小時制	ㄅㄚ　ㄒ｜ㄠˇ　ㄕˊ　ㄓˋ
把權	ㄅㄚˇ　ㄑㄩㄢˊ
印板兒	｜ㄣˋ　ㄅㄢˇㄦ　(變)｜ㄣˋ　ㄅㄚˇㄦ
八關齋	ㄅㄚ　ㄍㄨㄢ　ㄓㄞ
霸王	ㄅㄚˋ　ㄨㄤˊ
半斤八兩	ㄅㄢˋ　ㄐ｜ㄣ　ㄅㄚ　ㄌ｜ㄤˇ
序跋	ㄒㄩˋ　ㄅㄚˊ
八達嶺	ㄅㄚ　ㄉㄚˊ　ㄌ｜ㄥˇ
自打嘴巴	ㄗˋ　ㄉㄚˇ　ㄗㄨㄟˇ　˙ㄅㄚ
四面八方	ㄙˋ　ㄇ｜ㄢˋ　ㄅㄚ　ㄈㄤ
巴楚縣	ㄅㄚ　ㄔㄨˇ　ㄒ｜ㄢˋ
愛八哥兒	ㄞˋ　ㄅㄚ　˙ㄍㄜㄦ
八點檔	ㄅㄚ　ㄉ｜ㄢˇ　ㄉㄤˇ
超世拔俗	ㄔㄠ　ㄕˋ　ㄅㄚˊ　ㄙㄨˊ
八十歲學吹鼓手	ㄅㄚ　ㄕˊ　ㄙㄨㄟˋ　ㄒㄩㄝˊ　ㄔㄨㄟ　ㄍㄨˇ　ㄕㄡˇ
七扭八歪	ㄑ｜　ㄋ｜ㄡˇ　ㄅㄚ　ㄨㄞ
好把式	ㄏㄠˇ　ㄅㄚˇ　ㄕˋ
八千里路雲和月	ㄅㄚ　ㄑ｜ㄢ　ㄌ｜ˇ　ㄌㄨˋ　ㄩㄣˊ　ㄏㄜˊ　ㄩㄝˋ
八刀	ㄅㄚ　ㄉㄠ
八分	ㄅㄚ　ㄈㄣ
巴塞隆納	ㄅㄚ　ㄙㄞˋ　ㄌㄨㄥˊ　ㄋㄚˋ
旱魃為虐	ㄏㄢˋ　ㄅㄚˊ　ㄨㄟˊ　ㄋㄩㄝˋ
八刑	ㄅㄚ　ㄒ｜ㄥˊ
巴巴劫劫	ㄅㄚ　˙ㄅㄚ　˙ㄐ｜ㄝ　˙ㄐ｜ㄝ
弝	ㄅㄚˋ
搭伴	ㄉㄚ　ㄅㄢˋ　(變)ㄉㄚ　ㄅㄚˋㄦ
芭籬	ㄅㄚ　ㄌ｜ˊ
蓽茇	ㄅ｜ˋ　ㄅㄚˊ
辣瓣兒醬	ㄌㄚˋ　ㄅㄢˋㄦ　ㄐ｜ㄤˋ　(變)ㄌㄚˋ　ㄅㄚˋㄦ　ㄐ｜ㄤˋ
把兒缸子	ㄅㄚˋㄦ　ㄍㄤ　˙ㄗ
霸占	ㄅㄚˋ　ㄓㄢˋ
年把	ㄋ｜ㄢˊ　ㄅㄚˇ
野雞巴士	｜ㄝˇ　ㄐ｜　ㄅㄚ　ㄕˋ
霸王悲歌	ㄅㄚˋ　ㄨㄤˊ　ㄅㄟ　ㄍㄜ
窄巴	ㄓㄞˇ　˙ㄅㄚ
巴渝詞	ㄅㄚ　ㄩˊ　ㄘˊ
彭巴草原	ㄆㄥˊ　ㄅㄚ　ㄘㄠˇ　ㄩㄢˊ
一緊二慢三罷休	｜　ㄐ｜ㄣˇ　ㄦˋ　ㄇㄢˋ　ㄙㄢ　ㄅㄚˋ　ㄒ｜ㄡ
老爸	ㄌㄠˇ　ㄅㄚˋ
五霸	ㄨˇ　ㄅㄚˋ
八卦山	ㄅㄚ　ㄍㄨㄚˋ　ㄕㄢ
八音聯歡	ㄅㄚ　｜ㄣ　ㄌ｜ㄢˊ　ㄏㄨㄢ
四禪八定	ㄙˋ　ㄔㄢˊ　ㄅㄚ　ㄉ｜ㄥˋ
巴拉頓湖	ㄅㄚ　ㄌㄚ　ㄉㄨㄣˋ　ㄏㄨˊ
謀王圖霸	ㄇㄡˊ　ㄨㄤˊ　ㄊㄨˊ　ㄅㄚˋ
鼓鈸	ㄍㄨˇ　ㄅㄚˊ
把薪助火	ㄅㄚˇ　ㄒ｜ㄣ　ㄓㄨˋ　ㄏㄨㄛˇ
巴洛克風格	ㄅㄚ　ㄌㄨㄛˋ　ㄎㄜˋ　ㄈㄥ　ㄍㄜˊ
霸功	ㄅㄚˋ　ㄍㄨㄥ
巴嗤	ㄅㄚ　˙ㄔ
籬笆	ㄌ｜ˊ　˙ㄅㄚ
尺八	ㄔˇ　ㄅㄚ
八及	ㄅㄚ　ㄐ｜ˊ
拔苗助長	ㄅㄚˊ　ㄇ｜ㄠˊ　ㄓㄨˋ　ㄓㄤˇ
玩把戲	ㄨㄢˊ　ㄅㄚˇ　ㄒ｜ˋ
八珍	ㄅㄚ　ㄓㄣ
把式匠	ㄅㄚˇ　ㄕˋ　ㄐ｜ㄤˋ
嘎巴	ㄍㄚ　˙ㄅㄚ
巴旦杏	ㄅㄚ　ㄉㄢˋ　ㄒ｜ㄥˋ
忘八羔子	ㄨㄤˊ　˙ㄅㄚ　ㄍㄠ　˙ㄗ
為頭把腦	ㄨㄟˊ　ㄊㄡˊ　ㄅㄚˇ　ㄋㄠˇ
把話	ㄅㄚˇ　ㄏㄨㄚˋ
八卦陣	ㄅㄚ　ㄍㄨㄚˋ　ㄓㄣˋ
個把	ㄍㄜˋ　ㄅㄚˇ
封家十八姨	ㄈㄥ　ㄐ｜ㄚ　ㄕˊ　ㄅㄚ　｜ˊ
前不巴村，後不巴店	ㄑ｜ㄢˊ　ㄅㄨˋ　ㄅㄚ　ㄘㄨㄣ　ㄏㄡˋ　ㄅㄨˋ　ㄅㄚ　ㄉ｜ㄢˋ
雙層巴士	ㄕㄨㄤ　ㄘㄥˊ　ㄅㄚ　ㄕˋ
八九分人	ㄅㄚ　ㄐ｜ㄡˇ　ㄈㄣ　ㄖㄣˊ
巴斯卡加法器	ㄅㄚ　ㄙ　ㄎㄚˇ　ㄐ｜ㄚ　ㄈㄚˇ　ㄑ｜ˋ
釘鈀	ㄉ｜ㄥ　ㄅㄚˇ
掗把	｜ㄚˋ　˙ㄅㄚ
嘴把子	ㄗㄨㄟˇ　ㄅㄚˋ　˙ㄗ
飛靶射擊	ㄈㄟ　ㄅㄚˇ　ㄕㄜˋ　ㄐ｜ˊ
酒吧間	ㄐ｜ㄡˇ　ㄅㄚ　ㄐ｜ㄢ
拔犀擢象	ㄅㄚˊ　ㄒ｜　ㄓㄨㄛˊ　ㄒ｜ㄤˋ
馬拉巴栗	ㄇㄚˇ　ㄌㄚ　ㄅㄚ　ㄌ｜ˋ
倔巴棍子	ㄐㄩㄝˋ　˙ㄅㄚ　ㄍㄨㄣˋ　˙ㄗ
拔十得五	ㄅㄚˊ　ㄕˊ　ㄉㄜˊ　ㄨˇ
拔山志	ㄅㄚˊ　ㄕㄢ　ㄓˋ
反巴掌	ㄈㄢˇ　ㄅㄚ　˙ㄓㄤ
餈粑	ㄘˊ　˙ㄅㄚ
絣扒吊拷	ㄅㄥ　ㄅㄚ　ㄉ｜ㄠˋ　ㄎㄠˇ
八區	ㄅㄚ　ㄑㄩ
阿爸	ㄚ　ㄅㄚˋ
八字軍	ㄅㄚ　ㄗˋ　ㄐㄩㄣ
罷職	ㄅㄚˋ　ㄓˊ
把酒	ㄅㄚˇ　ㄐ｜ㄡˇ
巴丹半島	ㄅㄚ　ㄉㄢ　ㄅㄢˋ　ㄉㄠˇ
八卦	ㄅㄚ　ㄍㄨㄚˋ
吉魯巴	ㄐ｜ˊ　ㄌㄨˇ　ㄅㄚ
八旗子弟	ㄅㄚ　ㄑ｜ˊ　ㄗˇ　ㄉ｜ˋ
跋山涉川	ㄅㄚˊ　ㄕㄢ　ㄕㄜˋ　ㄔㄨㄢ
雜八湊兒	ㄗㄚˊ　˙ㄅㄚ　ㄘㄡˋㄦ
杷	（又音）˙ㄅㄚ
芭黎	ㄅㄚ　ㄌ｜ˊ
巴曼得海峽	ㄅㄚ　ㄇㄢˋ　ㄉㄜˊ　ㄏㄞˇ　ㄒ｜ㄚˊ
阿里巴巴與四十大盜	ㄚ　ㄌ｜ˇ　ㄅㄚ　ㄅㄚ　ㄩˇ　ㄙˋ　ㄕˊ　ㄉㄚˋ　ㄉㄠˋ
腰板兒	｜ㄠ　ㄅㄢˇㄦ　(變)｜ㄠ　ㄅㄚˇㄦ
罷免權	ㄅㄚˋ　ㄇ｜ㄢˇ　ㄑㄩㄢˊ
芭蕉布	ㄅㄚ　ㄐ｜ㄠ　ㄅㄨˋ
八極拳	ㄅㄚ　ㄐ｜ˊ　ㄑㄩㄢˊ
拔救	ㄅㄚˊ　ㄐ｜ㄡˋ
十八變	ㄕˊ　ㄅㄚ　ㄅ｜ㄢˋ
把弦兒	ㄅㄚˇ　ㄒ｜ㄢˊㄦ　(變)ㄅㄚˇ　ㄒ｜ㄚˊㄦ
一毛不拔	｜　ㄇㄠˊ　ㄅㄨˋ　ㄅㄚˊ
八指頭陀	ㄅㄚ　ㄓˇ　ㄊㄡˊ　ㄊㄨㄛˊ
阿爾巴尼亞共和國	ㄚ　ㄦˇ　ㄅㄚ　ㄋ｜ˊ　｜ㄚˋ　ㄍㄨㄥˋ　ㄏㄜˊ　ㄍㄨㄛˊ
揚州八怪	｜ㄤˊ　ㄓㄡ　ㄅㄚ　ㄍㄨㄞˋ
八成新	ㄅㄚ　ㄔㄥˊ　ㄒ｜ㄣ
淋巴腺	ㄌ｜ㄣˊ　ㄅㄚ　ㄒ｜ㄢˋ
八郎	ㄅㄚ　ㄌㄤˊ
偷雞不著蝕把米	ㄊㄡ　ㄐ｜　ㄅㄨˋ　ㄓㄠˊ　ㄕˊ　ㄅㄚˇ　ㄇ｜ˇ
拔來報往	ㄅㄚˊ　ㄌㄞˊ　ㄅㄠˋ　ㄨㄤˇ
吧嗒	ㄅㄚ　˙ㄉㄚ
八正道	ㄅㄚ　ㄓㄥˋ　ㄉㄠˋ
稱霸	ㄔㄥ　ㄅㄚˋ
八都	ㄅㄚ　ㄉㄨ
灞陵夜獵	ㄅㄚˋ　ㄌ｜ㄥˊ　｜ㄝˋ　ㄌ｜ㄝˋ
琉璃喇叭	ㄌ｜ㄡˊ　ㄌ｜ˊ　ㄌㄚˇ　˙ㄅㄚ
吧唧	ㄅㄚ　˙ㄐ｜
揣奸把猾	ㄔㄨㄞˇ　ㄐ｜ㄢ　ㄅㄚˇ　ㄏㄨㄚˊ
八棍子撂不著	ㄅㄚ　ㄍㄨㄣˋ　˙ㄗ　ㄌ｜ㄠˋ　ㄅㄨˋ　ㄓㄠˊ
跋嘴	ㄅㄚˊ　ㄗㄨㄟˇ
亨利八世	ㄏㄥ　ㄌ｜ˋ　ㄅㄚ　ㄕˋ
巴爾喀什湖	ㄅㄚ　ㄦˇ　ㄎㄚˋ　ㄕˊ　ㄏㄨˊ
拔旗	ㄅㄚˊ　ㄑ｜ˊ
巴陵	ㄅㄚ　ㄌ｜ㄥˊ
虎口拔牙	ㄏㄨˇ　ㄎㄡˇ　ㄅㄚˊ　｜ㄚˊ
巴圖魯	ㄅㄚ　ㄊㄨˊ　ㄌㄨˇ
古典芭蕾	ㄍㄨˇ　ㄉ｜ㄢˇ　ㄅㄚ　ㄌㄟˇ
力巴兒	ㄌ｜ˋ　˙ㄅㄚㄦ
靶機	ㄅㄚˇ　ㄐ｜
鹽巴	｜ㄢˊ　ㄅㄚ
丈八蛇矛	ㄓㄤˋ　ㄅㄚ　ㄕㄜˊ　ㄇㄠˊ
利巴	ㄌ｜ˋ　ㄅㄚ
打把攔	ㄉㄚˇ　ㄅㄚˇ　ㄌㄢˊ
嘴巴巴	ㄗㄨㄟˇ　ㄅㄚ　ㄅㄚ
八遐	ㄅㄚ　ㄒ｜ㄚˊ
八達	ㄅㄚ　ㄉㄚˊ
明是一盆火，暗是一把刀	ㄇ｜ㄥˊ　ㄕˋ　｜　ㄆㄣˊ　ㄏㄨㄛˇ　ㄢˋ　ㄕˋ　｜　ㄅㄚˇ　ㄉㄠ
拔薤	ㄅㄚˊ　ㄒ｜ㄝˋ
王霸	ㄨㄤˊ　ㄅㄚˋ
力巴	ㄌ｜ˋ　˙ㄅㄚ
巴多尼	ㄅㄚ　ㄉㄨㄛ　ㄋ｜ˊ
揪尾巴	ㄐ｜ㄡ　ㄨㄟˇ　˙ㄅㄚ
七斷八續	ㄑ｜　ㄉㄨㄢˋ　ㄅㄚ　ㄒㄩˋ
挺起腰板兒	ㄊ｜ㄥˇ　ㄑ｜ˇ　｜ㄠ　ㄅㄢˇㄦ　(變)ㄊ｜ㄥˇ　ㄑ｜ˇ　｜ㄠ　ㄅㄚˇㄦ
金奔巴	ㄐ｜ㄣ　ㄅㄣ　ㄅㄚ
老八板兒	ㄌㄠˇ　ㄅㄚ　ㄅㄢˇㄦ　(變)ㄌㄠˇ　ㄅㄚ　ㄅㄚˇㄦ
八路軍	ㄅㄚ　ㄌㄨˋ　ㄐㄩㄣ
拔葵	ㄅㄚˊ　ㄎㄨㄟˊ
萬把	ㄨㄢˋ　˙ㄅㄚ
善罷干休	ㄕㄢˋ　ㄅㄚˋ　ㄍㄢ　ㄒ｜ㄡ
七八	ㄑ｜　ㄅㄚ
七上八下	ㄑ｜　ㄕㄤˋ　ㄅㄚ　ㄒ｜ㄚˋ
善罷甘休	ㄕㄢˋ　ㄅㄚˋ　ㄍㄢ　ㄒ｜ㄡ
不拔	ㄅㄨˋ　ㄅㄚˊ
拔摋	ㄅㄚˊ　ㄕㄚ
放禿尾巴鷹	ㄈㄤˋ　ㄊㄨ　ㄨㄟˇ　˙ㄅㄚ　｜ㄥ
宗喀巴	ㄗㄨㄥ　ㄎㄚˋ　ㄅㄚ
冷灶上著一把兒，熱灶上著一把兒	ㄌㄥˇ　ㄗㄠˋ　ㄕㄤˋ　ㄓㄠˊ　｜　ㄅㄚˇㄦ　ㄖㄜˋ　ㄗㄠˋ　ㄕㄤˋ　ㄓㄠˊ　｜　ㄅㄚˇㄦ
八仙桌	ㄅㄚ　ㄒ｜ㄢ　ㄓㄨㄛ
把街	ㄅㄚˇ　ㄐ｜ㄝ
八里	ㄅㄚ　ㄌ｜ˇ
賊王八	ㄗㄟˊ　ㄨㄤˊ　ㄅㄚ
投機倒把	ㄊㄡˊ　ㄐ｜　ㄉㄠˋ　ㄅㄚˇ
瘦巴巴	ㄕㄡˋ　ㄅㄚ　ㄅㄚ
天龍八部	ㄊ｜ㄢ　ㄌㄨㄥˊ　ㄅㄚ　ㄅㄨˋ
拔萃	ㄅㄚˊ　ㄘㄨㄟˋ
八卦米篩	ㄅㄚ　ㄍㄨㄚˋ　ㄇ｜ˇ　ㄕㄞ
胡說八道	ㄏㄨˊ　ㄕㄨㄛ　ㄅㄚ　ㄉㄠˋ
拔短籌	ㄅㄚˊ　ㄉㄨㄢˇ　ㄔㄡˊ
練把式	ㄌ｜ㄢˋ　ㄅㄚˇ　˙ㄕ
吧吧	ㄅㄚ　ㄅㄚ
八儒	ㄅㄚ　ㄖㄨˊ
罷戰	ㄅㄚˋ　ㄓㄢˋ
撈起嘴巴	ㄌㄠ　ㄑ｜ˇ　ㄗㄨㄟˇ　˙ㄅㄚ
拔擢	ㄅㄚˊ　ㄓㄨㄛˊ
把袂	ㄅㄚˇ　ㄇㄟˋ
琶	（又音）˙ㄅㄚ
土霸王	ㄊㄨˇ　ㄅㄚˋ　ㄨㄤˊ
八角鼓	ㄅㄚ　ㄐ｜ㄠˇ　ㄍㄨˇ
拔都魯	ㄅㄚˊ　ㄉㄨ　ㄌㄨˇ
八法頌	ㄅㄚ　ㄈㄚˇ　ㄙㄨㄥˋ
耍把戲	ㄕㄨㄚˇ　ㄅㄚˇ　ㄒ｜ˋ
九朽一罷	ㄐ｜ㄡˇ　ㄒ｜ㄡˇ　｜　ㄅㄚˋ
巴里庫廷火山	ㄅㄚ　ㄌ｜ˇ　ㄎㄨˋ　ㄊ｜ㄥˊ　ㄏㄨㄛˇ　ㄕㄢ
兩把頭	ㄌ｜ㄤˇ　ㄅㄚˇ　ㄊㄡˊ
七八成	ㄑ｜　ㄅㄚ　ㄔㄥˊ
八元	ㄅㄚ　ㄩㄢˊ
傷疤	ㄕㄤ　ㄅㄚ
巴圖	ㄅㄚ　ㄊㄨˊ
巴哈馬群島	ㄅㄚ　ㄏㄚ　ㄇㄚˇ　ㄑㄩㄣˊ　ㄉㄠˇ
巴拉芬	ㄅㄚ　ㄌㄚ　ㄈㄣ
拔距	ㄅㄚˊ　ㄐㄩˋ
巴國	ㄅㄚ　ㄍㄨㄛˊ
不把將軍為神道	ㄅㄨˋ　ㄅㄚˇ　ㄐ｜ㄤ　ㄐㄩㄣ　ㄨㄟˊ　ㄕㄣˊ　ㄉㄠˋ
七通八達	ㄑ｜　ㄊㄨㄥ　ㄅㄚ　ㄉㄚˊ
耳聽八方	ㄦˇ　ㄊ｜ㄥ　ㄅㄚ　ㄈㄤ
罷手	ㄅㄚˋ　ㄕㄡˇ
八公	ㄅㄚ　ㄍㄨㄥ
沒把柄	ㄇㄟˊ　ㄅㄚˇ　ㄅ｜ㄥˇ
肋巴扇兒	ㄌㄟˋ　ㄅㄚ　ㄕㄢˋㄦ　(變)ㄌㄟˋ　˙ㄅㄚ　ㄕㄚˋㄦ
二五八	ㄦˋ　ㄨˇ　ㄅㄚ
霸道	ㄅㄚˋ　ㄉㄠˋ
十之八九	ㄕˊ　ㄓ　ㄅㄚ　ㄐ｜ㄡˇ
拔步	ㄅㄚˊ　ㄅㄨˋ
八座	ㄅㄚ　ㄗㄨㄛˋ
七零八散	ㄑ｜　ㄌ｜ㄥˊ　ㄅㄚ　ㄙㄢˇ
重力壩	ㄓㄨㄥˋ　ㄌ｜ˋ　ㄅㄚˋ
巴黎和約	ㄅㄚ　ㄌ｜ˊ　ㄏㄜˊ　ㄩㄝ
拔萃書室	ㄅㄚˊ　ㄘㄨㄟˋ　ㄕㄨ　ㄕˋ
大煠八塊	ㄉㄚˋ　｜ㄝˋ　ㄅㄚ　ㄎㄨㄞˋ
八陣圖	ㄅㄚ　ㄓㄣˋ　ㄊㄨˊ
巴基斯坦	ㄅㄚ　ㄐ｜　ㄙ　ㄊㄢˇ
三八婦女節	ㄙㄢ　ㄅㄚ　ㄈㄨˋ　ㄋㄩˇ　ㄐ｜ㄝˊ
阿拉巴馬州	ㄚ　ㄌㄚ　ㄅㄚ　ㄇㄚˇ　ㄓㄡ
把上了	ㄅㄚˇ　ㄕㄤˋ　˙ㄌㄜ
八廚	ㄅㄚ　ㄔㄨˊ
拔葵去織	ㄅㄚˊ　ㄎㄨㄟˊ　ㄑㄩˋ　ㄓ
結巴子	ㄐ｜ㄝ　ㄅㄚ　˙ㄗ
倒拔蛇	ㄉㄠˋ　ㄅㄚˊ　ㄕㄜˊ
大霸尖山	ㄉㄚˋ　ㄅㄚˋ　ㄐ｜ㄢ　ㄕㄢ
拓跋	ㄊㄨㄛˋ　ㄅㄚˊ
把杯	ㄅㄚˇ　ㄅㄟ
銅鈸	ㄊㄨㄥˊ　ㄅㄚˊ
第二把手	ㄉ｜ˋ　ㄦˋ　ㄅㄚˇ　ㄕㄡˇ
喀爾巴阡山脈	ㄎㄚˋ　ㄦˇ　ㄅㄚ　ㄑ｜ㄢ　ㄕㄢ　ㄇㄞˋ
八寶粥	ㄅㄚ　ㄅㄠˇ　ㄓㄡ
巴哈	ㄅㄚ　ㄏㄚ
七死八活	ㄑ｜　ㄙˇ　ㄅㄚ　ㄏㄨㄛˊ
八斗才	ㄅㄚ　ㄉㄡˇ　ㄘㄞˊ
土八路	ㄊㄨˇ　ㄅㄚ　ㄌㄨˋ
露尾巴	ㄌㄨˋ　ㄨㄟˇ　ㄅㄚ
門巴族	ㄇㄣˊ　ㄅㄚ　ㄗㄨˊ
疤瘌餅	ㄅㄚ　˙ㄌㄚ　ㄅ｜ㄥˇ
四時八節	ㄙˋ　ㄕˊ　ㄅㄚ　ㄐ｜ㄝˊ
看把戲	ㄎㄢˋ　ㄅㄚˇ　ㄒ｜ˋ
把梢的	ㄅㄚˇ　ㄕㄠ　˙ㄉㄜ
同性戀酒吧	ㄊㄨㄥˊ　ㄒ｜ㄥˋ　ㄌ｜ㄢˋ　ㄐ｜ㄡˇ　ㄅㄚ
古巴事件	ㄍㄨˇ　ㄅㄚ　ㄕˋ　ㄐ｜ㄢˋ
乾巴疵咧	ㄍㄢ　˙ㄅㄚ　ㄘ　ㄌ｜ㄝ
出類拔萃	ㄔㄨ　ㄌㄟˋ　ㄅㄚˊ　ㄘㄨㄟˋ
選拔賽	ㄒㄩㄢˇ　ㄅㄚˊ　ㄙㄞˋ
巴頓	ㄅㄚ　ㄉㄨㄣˋ
旱魃	ㄏㄢˋ　ㄅㄚˊ
把柄	ㄅㄚˇ　ㄅ｜ㄥˇ
八幡	ㄅㄚ　ㄈㄢ
八敗命	ㄅㄚ　ㄅㄞˋ　ㄇ｜ㄥˋ
環繞喇叭	ㄏㄨㄢˊ　ㄖㄠˋ　ㄌㄚˇ　˙ㄅㄚ
弔拷繃扒	ㄉ｜ㄠˋ　ㄎㄠˇ　ㄅㄥ　ㄅㄚ
京八寸	ㄐ｜ㄥ　ㄅㄚ　ㄘㄨㄣˋ
霸陵縣	ㄅㄚˋ　ㄌ｜ㄥˊ　ㄒ｜ㄢˋ
八幽	ㄅㄚ　｜ㄡ
拔山力	ㄅㄚˊ　ㄕㄢ　ㄌ｜ˋ
鈀子拳	ㄅㄚˇ　ㄗˇ　ㄑㄩㄢˊ
钂鈀	ㄊㄤˇ　ㄅㄚˇ
王八蛋	ㄨㄤˊ　˙ㄅㄚ　ㄉㄢˋ
八抬八簇	ㄅㄚ　ㄊㄞˊ　ㄅㄚ　ㄘㄨˋ
八龍	ㄅㄚ　ㄌㄨㄥˊ
喇叭花	ㄌㄚˇ　˙ㄅㄚ　ㄏㄨㄚ
楚霸王困垓下	ㄔㄨˇ　ㄅㄚˋ　ㄨㄤˊ　ㄎㄨㄣˋ　ㄍㄞ　ㄒ｜ㄚˋ
符拔	ㄈㄨˊ　ㄅㄚˊ
胡二巴越	ㄏㄨˊ　ㄦˋ　ㄅㄚ　ㄩㄝˋ
八十四調	ㄅㄚ　ㄕˊ　ㄙˋ　ㄉ｜ㄠˋ
欲罷不能	ㄩˋ　ㄅㄚˋ　ㄅㄨˋ　ㄋㄥˊ
八德	ㄅㄚ　ㄉㄜˊ
霸府	ㄅㄚˋ　ㄈㄨˇ
巴斯特納克	ㄅㄚ　ㄙ　ㄊㄜˋ　ㄋㄚˋ　ㄎㄜˋ
窗兒眼吹喇叭	ㄔㄨㄤㄦ　｜ㄢˇ　ㄔㄨㄟ　ㄌㄚˇ　˙ㄅㄚ
掃把	ㄙㄠˋ　ㄅㄚˇ
酒吧女	ㄐ｜ㄡˇ　ㄅㄚ　ㄋㄩˇ
七拖八欠	ㄑ｜　ㄊㄨㄛ　ㄅㄚ　ㄑ｜ㄢˋ
眼巴巴	｜ㄢˇ　ㄅㄚ　ㄅㄚ
拔萃出類	ㄅㄚˊ　ㄘㄨㄟˋ　ㄔㄨ　ㄌㄟˋ
扒	ㄅㄚ
拔山超海	ㄅㄚˊ　ㄕㄢ　ㄔㄠ　ㄏㄞˇ
踏鈸	ㄊㄚˋ　ㄅㄚˊ
惡霸	ㄜˋ　ㄅㄚˋ
霸陵折柳	ㄅㄚˋ　ㄌ｜ㄥˊ　ㄓㄜˊ　ㄌ｜ㄡˇ
放刁把濫	ㄈㄤˋ　ㄉ｜ㄠ　ㄅㄚˇ　ㄌㄢˋ
八花九裂	ㄅㄚ　ㄏㄨㄚ　ㄐ｜ㄡˇ　ㄌ｜ㄝˋ
伊斯巴罕	｜　ㄙ　ㄅㄚ　ㄏㄢˇ
人情一把鋸	ㄖㄣˊ　ㄑ｜ㄥˊ　｜　ㄅㄚˇ　ㄐㄩˋ
八搭麻鞋	ㄅㄚ　ㄉㄚ　ㄇㄚˊ　ㄒ｜ㄝˊ
雋拔	ㄐㄩㄣˋ　ㄅㄚˊ
把晤	ㄅㄚˇ　ㄨˋ
七零八落	ㄑ｜　ㄌ｜ㄥˊ　ㄅㄚ　ㄌㄨㄛˋ
老鼠尾巴上害癤子	ㄌㄠˇ　ㄕㄨˇ　ㄨㄟˇ　˙ㄅㄚ　ㄕㄤˋ　ㄏㄞˋ　ㄐ｜ㄝˊ　˙ㄗ
八表	ㄅㄚ　ㄅ｜ㄠˇ
霸縣	ㄅㄚˋ　ㄒ｜ㄢˋ
吉特巴	ㄐ｜ˊ　ㄊㄜˋ　ㄅㄚ
八百壯士	ㄅㄚ　ㄅㄞˇ　ㄓㄨㄤˋ　ㄕˋ
夾著尾巴	ㄐ｜ㄚˊ　˙ㄓㄜ　ㄨㄟˇ　˙ㄅㄚ
急巴巴	ㄐ｜ˊ　ㄅㄚ　ㄅㄚ
八方呼應	ㄅㄚ　ㄈㄤ　ㄏㄨ　｜ㄥˋ
飛揚跋扈	ㄈㄟ　｜ㄤˊ　ㄅㄚˊ　ㄏㄨˋ
二拉八當	ㄦˋ　˙ㄌㄚ　ㄅㄚ　ㄉㄤˋ
巴爾沙	ㄅㄚ　ㄦˇ　ㄕㄚ
八斗陳思	ㄅㄚ　ㄉㄡˇ　ㄔㄣˊ　ㄙ
選拔	ㄒㄩㄢˇ　ㄅㄚˊ
酸巴溜丟	ㄙㄨㄢ　˙ㄅㄚ　ㄌ｜ㄡ　ㄉ｜ㄡ
永州八記	ㄩㄥˇ　ㄓㄡ　ㄅㄚ　ㄐ｜ˋ
拔著短籌	ㄅㄚˊ　ㄓㄠˊ　ㄉㄨㄢˇ　ㄔㄡˊ
哈叭狗兒咬虼蚤	ㄏㄚˇ　ㄅㄚ　ㄍㄡˇㄦ　｜ㄠˇ　ㄍㄜˋ　ㄗㄠˇ
喇叭手	ㄌㄚˇ　˙ㄅㄚ　ㄕㄡˇ
連拱壩	ㄌ｜ㄢˊ　ㄍㄨㄥˇ　ㄅㄚˋ
不巴譜	ㄅㄨˋ　ㄅㄚ　ㄆㄨˇ
拔檔	ㄅㄚˊ　ㄉㄤˇ
一個巴掌拍不響	｜　˙ㄍㄜ　ㄅㄚ　ㄓㄤˇ　ㄆㄞ　ㄅㄨˋ　ㄒ｜ㄤˇ
八月春	ㄅㄚ　ㄩㄝˋ　ㄔㄨㄣ
拔掉	ㄅㄚˊ　ㄉ｜ㄠˋ
緊巴巴	ㄐ｜ㄣˇ　ㄅㄚ　ㄅㄚ
巴人調	ㄅㄚ　ㄖㄣˊ　ㄉ｜ㄠˋ
貢八	ㄍㄨㄥˋ　ㄅㄚ
守把	ㄕㄡˇ　ㄅㄚˇ
拿印把兒	ㄋㄚˊ　｜ㄣˋ　ㄅㄚˇㄦ
八岔	ㄅㄚ　ㄔㄚˋ
一手提拔	｜　ㄕㄡˇ　ㄊ｜ˊ　ㄅㄚˊ
把攬	ㄅㄚˇ　˙ㄌㄢ
外八字腳	ㄨㄞˋ　ㄅㄚ　ㄗˋ　ㄐ｜ㄠˇ
仰八叉	｜ㄤˇ　˙ㄅㄚ　ㄔㄚ
挺拔不群	ㄊ｜ㄥˇ　ㄅㄚˊ　ㄅㄨˋ　ㄑㄩㄣˊ
七歪八倒	ㄑ｜　ㄨㄞ　ㄅㄚ　ㄉㄠˇ
七手八腳	ㄑ｜　ㄕㄡˇ　ㄅㄚ　ㄐ｜ㄠˇ
八字腳	ㄅㄚ　ㄗˋ　ㄐ｜ㄠˇ
博巴	ㄅㄛˊ　ㄅㄚ
巴黎綠	ㄅㄚ　ㄌ｜ˊ　ㄌㄩˋ
七高八低	ㄑ｜　ㄍㄠ　ㄅㄚ　ㄉ｜
八專	ㄅㄚ　ㄓㄨㄢ
淋巴液	ㄌ｜ㄣˊ　ㄅㄚ　｜ㄝˋ
巴蛇食象	ㄅㄚ　ㄕㄜˊ　ㄕˊ　ㄒ｜ㄤˋ
八卦鏡	ㄅㄚ　ㄍㄨㄚˋ　ㄐ｜ㄥˋ
更待干罷	ㄍㄥˋ　ㄉㄞˋ　ㄍㄢ　ㄅㄚˋ
巴氏桿菌	ㄅㄚ　ㄕˋ　ㄍㄢˇ　ㄐㄩㄣˋ
前人失腳，後人把滑	ㄑ｜ㄢˊ　ㄖㄣˊ　ㄕ　ㄐ｜ㄠˇ　ㄏㄡˋ　ㄖㄣˊ　ㄅㄚˇ　ㄏㄨㄚˊ
拔解	ㄅㄚˊ　ㄐ｜ㄝˋ
把斂	ㄅㄚˇ　˙ㄌ｜ㄢ
阿迪斯阿貝巴	ㄚ　ㄉ｜ˊ　ㄙ　ㄚ　ㄅㄟˋ　ㄅㄚ
把斷	ㄅㄚˇ　ㄉㄨㄢˋ
倒了八輩子楣	ㄉㄠˇ　˙ㄌㄜ　ㄅㄚ　ㄅㄟˋ　˙ㄗ　ㄇㄟˊ
箭靶	ㄐ｜ㄢˋ　ㄅㄚˇ
罷休	ㄅㄚˋ　ㄒ｜ㄡ
八功德水	ㄅㄚ　ㄍㄨㄥ　ㄉㄜˊ　ㄕㄨㄟˇ
八索九丘	ㄅㄚ　ㄙㄨㄛˇ　ㄐ｜ㄡˇ　ㄑ｜ㄡ
吧女	ㄅㄚ　ㄋㄩˇ
結結巴巴	ㄐ｜ㄝ　˙ㄐ｜ㄝ　ㄅㄚ　ㄅㄚ
二把手車子	ㄦˋ　ㄅㄚˇ　ㄕㄡˇ　ㄔㄜ　˙ㄗ
永字八法	ㄩㄥˇ　ㄗˋ　ㄅㄚ　ㄈㄚˇ
拔親	ㄅㄚˊ　ㄑ｜ㄣ
倒把鋤頭	ㄉㄠˋ　ㄅㄚˇ　ㄔㄨˊ　˙ㄊㄡ
霸陵尉	ㄅㄚˋ　ㄌ｜ㄥˊ　ㄨㄟˋ
芭樂票	ㄅㄚ　ㄌㄜˋ　ㄆ｜ㄠˋ
繃扒弔拷	ㄅㄥ　ㄅㄚ　ㄉ｜ㄠˋ　ㄎㄠˇ
雞巴	ㄐ｜　˙ㄅㄚ
板兒	ㄅㄢˇㄦ　(變)ㄅㄚˇㄦ
有把傢伙	｜ㄡˇ　˙ㄅㄚ　ㄐ｜ㄚ　˙ㄏㄨㄛ
八字鬍鬚	ㄅㄚ　ㄗˋ　ㄏㄨˊ　ㄒㄩ
漏風的巴掌	ㄌㄡˋ　ㄈㄥ　˙ㄉㄜ　ㄅㄚ　˙ㄓㄤ
望八	ㄨㄤˋ　ㄅㄚ
漁霸	ㄩˊ　ㄅㄚˋ
繃巴	ㄅㄥ　ㄅㄚ
濟拔	ㄐ｜ˋ　ㄅㄚˊ
八字沒見一撇	ㄅㄚ　ㄗˋ　ㄇㄟˊ　ㄐ｜ㄢˋ　｜　ㄆ｜ㄝˇ
八一三之役	ㄅㄚ　｜　ㄙㄢ　ㄓ　｜ˋ
瘡疤	ㄔㄨㄤ　ㄅㄚ
罷了	ㄅㄚˋ　˙ㄌㄜ（又音）ㄅㄚˋ　ㄌ｜ㄠˇ
八德市	ㄅㄚ　ㄉㄜˊ　ㄕˋ
珞巴族	ㄌㄨㄛˋ　ㄅㄚ　ㄗㄨˊ
八維	ㄅㄚ　ㄨㄟˊ
把不到	ㄅㄚˇ　ㄅㄨˋ　ㄉㄠˋ
八綱	ㄅㄚ　ㄍㄤ
阿米巴原蟲	ㄚ　ㄇ｜ˇ　ㄅㄚ　ㄩㄢˊ　ㄔㄨㄥˊ
罷亞	ㄅㄚˋ　｜ㄚˋ
老虎嘴上拔毛	ㄌㄠˇ　ㄏㄨˇ　ㄗㄨㄟˇ　ㄕㄤˋ　ㄅㄚˊ　ㄇㄠˊ
拜把兄弟	ㄅㄞˋ　ㄅㄚˇ　ㄒㄩㄥ　ㄉ｜ˋ
哈叭狗	ㄏㄚˇ　ㄅㄚ　ㄍㄡˇ
嘎叭	ㄍㄚ　ㄅㄚ
八答鞋	ㄅㄚ　ㄉㄚ　ㄒ｜ㄝˊ
海瑞罷官	ㄏㄞˇ　ㄖㄨㄟˋ　ㄅㄚˋ　ㄍㄨㄢ
笆壁	ㄅㄚ　ㄅ｜ˋ
瓠巴	ㄏㄨˋ　ㄅㄚ
拔短梯	ㄅㄚˊ　ㄉㄨㄢˇ　ㄊ｜
下里巴人	ㄒ｜ㄚˋ　ㄌ｜ˇ　ㄅㄚ　ㄖㄣˊ
巴什吉爾	ㄅㄚ　ㄕˊ　ㄐ｜ˊ　ㄦˇ
八大八小	ㄅㄚ　ㄉㄚˋ　ㄅㄚ　ㄒ｜ㄠˇ
巴答	ㄅㄚ　ㄉㄚ
巴子	ㄅㄚ　˙ㄗ
巴特那	ㄅㄚ　ㄊㄜˋ　ㄋㄚˋ
八九分	ㄅㄚ　ㄐ｜ㄡˇ　ㄈㄣ
望巴巴	ㄨㄤˋ　ㄅㄚ　ㄅㄚ
八紘	ㄅㄚ　ㄏㄨㄥˊ
八索	ㄅㄚ　ㄙㄨㄛˇ
虎嘴上拔毛	ㄏㄨˇ　ㄗㄨㄟˇ　ㄕㄤˋ　ㄅㄚˊ　ㄇㄠˊ
把持不定	ㄅㄚˇ　ㄔˊ　ㄅㄨˋ　ㄉ｜ㄥˋ
八一七公報	ㄅㄚ　｜　ㄑ｜　ㄍㄨㄥ　ㄅㄠˋ
拿把不住	ㄋㄚˊ　ㄅㄚˇ　ㄅㄨˋ　ㄓㄨˋ
凶巴巴	ㄒㄩㄥ　ㄅㄚ　ㄅㄚ
不能自拔	ㄅㄨˋ　ㄋㄥˊ　ㄗˋ　ㄅㄚˊ
朗巴兒	ㄌㄤˇ　ㄅㄚㄦ
吊拷絣把	ㄉ｜ㄠˋ　ㄎㄠˇ　ㄅㄥ　ㄅㄚˇ
霸王風月	ㄅㄚˋ　ㄨㄤˊ　ㄈㄥ　ㄩㄝˋ
八大人覺	ㄅㄚ　ㄉㄚˋ　ㄖㄣˊ　ㄐㄩㄝˊ
一把死拿兒	｜　ㄅㄚˇ　ㄙˇ　ㄋㄚˊㄦ
一戰而霸	｜　ㄓㄢˋ　ㄦˊ　ㄅㄚˋ
巴氏體	ㄅㄚ　ㄕˋ　ㄊ｜ˇ
拉巴特	ㄌㄚ　ㄅㄚ　ㄊㄜˋ
活靶子	ㄏㄨㄛˊ　ㄅㄚˇ　˙ㄗ
巴米揚	ㄅㄚ　ㄇ｜ˇ　｜ㄤˊ
羊撞籬笆	｜ㄤˊ　ㄓㄨㄤˋ　ㄌ｜ˊ　˙ㄅㄚ
把持	ㄅㄚˇ　ㄔˊ
巴峽	ㄅㄚ　ㄒ｜ㄚˊ
報罷	ㄅㄠˋ　ㄅㄚˋ
土巴號	ㄊㄨˇ　ㄅㄚ　ㄏㄠˋ
巴南牆望	ㄅㄚ　ㄋㄢˊ　ㄑ｜ㄤˊ　ㄨㄤˋ
巴黎盆地	ㄅㄚ　ㄌ｜ˊ　ㄆㄣˊ　ㄉ｜ˋ
阿巴桑	ㄜ　ㄅㄚ　ㄙㄤ
八王之亂	ㄅㄚ　ㄨㄤˊ　ㄓ　ㄌㄨㄢˋ
巴塞爾	ㄅㄚ　ㄙㄞˋ　ㄦˇ
斯巴達	ㄙ　ㄅㄚ　ㄉㄚˊ
狼跋	ㄌㄤˊ　ㄅㄚˊ
經板兒	ㄐ｜ㄥ　ㄅㄢˇㄦ　(變)ㄐ｜ㄥ　ㄅㄚˇㄦ
巴陵山	ㄅㄚ　ㄌ｜ㄥˊ　ㄕㄢ
路見不平，拔刀相助	ㄌㄨˋ　ㄐ｜ㄢˋ　ㄅㄨˋ　ㄆ｜ㄥˊ　ㄅㄚˊ　ㄉㄠ　ㄒ｜ㄤ　ㄓㄨˋ
把捉	ㄅㄚˇ　ㄓㄨㄛ
八分儀	ㄅㄚ　ㄈㄣ　｜ˊ
八體	ㄅㄚ　ㄊ｜ˇ
喇叭蟲	ㄌㄚˇ　˙ㄅㄚ　ㄔㄨㄥˊ
老實巴交	ㄌㄠˇ　˙ㄕ　ㄅㄚ　ㄐ｜ㄠ
舉鼎拔山	ㄐㄩˇ　ㄉ｜ㄥˇ　ㄅㄚˊ　ㄕㄢ
軷	ㄅㄚˊ
霸王鞭	ㄅㄚˋ　ㄨㄤˊ　ㄅ｜ㄢ
拔濟	ㄅㄚˊ　ㄐ｜ˋ
呱嗒板兒	ㄍㄨㄚ　˙ㄉㄚ　ㄅㄢˇㄦ　(變)ㄍㄨㄚ　˙ㄉㄚ　ㄅㄚˇㄦ
拔俗	ㄅㄚˊ　ㄙㄨˊ
松尾芭蕉	ㄙㄨㄥ　ㄨㄟˇ　ㄅㄚ　ㄐ｜ㄠ
巴山	ㄅㄚ　ㄕㄢ
刀靶兒	ㄉㄠ　ㄅㄚˇㄦ
大解八塊	ㄉㄚˋ　ㄐ｜ㄝˇ　ㄅㄚ　ㄎㄨㄞˋ
亂七八糟	ㄌㄨㄢˋ　ㄑ｜　ㄅㄚ　ㄗㄠ
沒巴避	ㄇㄟˊ　ㄅㄚ　ㄅ｜ˋ
森巴	ㄙㄣ　ㄅㄚ
八旗制度	ㄅㄚ　ㄑ｜ˊ　ㄓˋ　ㄉㄨˋ
七顛八倒	ㄑ｜　ㄉ｜ㄢ　ㄅㄚ　ㄉㄠˇ
跋履	ㄅㄚˊ　ㄌㄩˇ
八寶飯	ㄅㄚ　ㄅㄠˇ　ㄈㄢˋ
拔地而起	ㄅㄚˊ　ㄉ｜ˋ　ㄦˊ　ㄑ｜ˇ
籠驢把馬	ㄌㄨㄥˊ　ㄌㄩˊ　ㄅㄚˇ　ㄇㄚˇ
拔群出萃	ㄅㄚˊ　ㄑㄩㄣˊ　ㄔㄨ　ㄘㄨㄟˋ
八家四六文鈔	ㄅㄚ　ㄐ｜ㄚ　ㄙˋ　ㄌ｜ㄡˋ　ㄨㄣˊ　ㄔㄠ
拔	ㄅㄚˊ
拔罐子	ㄅㄚˊ　ㄍㄨㄢˋ　˙ㄗ
馬尾巴	ㄇㄚˇ　ㄨㄟˇ　˙ㄅㄚ
捏一把冷汗	ㄋ｜ㄝ　｜　ㄅㄚˇ　ㄌㄥˇ　ㄏㄢˋ
把持不住	ㄅㄚˇ　ㄔˊ　ㄅㄨˋ　ㄓㄨˋ
弩張劍拔	ㄋㄨˇ　ㄓㄤ　ㄐ｜ㄢˋ　ㄅㄚˊ
灞陵呵夜	ㄅㄚˋ　ㄌ｜ㄥˊ　ㄏㄜ　｜ㄝˋ
矲	ㄅㄚˋ
揪心扒肝	ㄐ｜ㄡ　ㄒ｜ㄣ　ㄅㄚ　ㄍㄢ
把握	ㄅㄚˇ　ㄨㄛˋ
同志酒吧	ㄊㄨㄥˊ　ㄓˋ　ㄐ｜ㄡˇ　ㄅㄚ
八步周行	ㄅㄚ　ㄅㄨˋ　ㄓㄡ　ㄒ｜ㄥˊ
巴嶺山脈	ㄅㄚ　ㄌ｜ㄥˇ　ㄕㄢ　ㄇㄞˋ
一字入公門，九牛拔不出	｜　ㄗˋ　ㄖㄨˋ　ㄍㄨㄥ　ㄇㄣˊ　ㄐ｜ㄡˇ　ㄋ｜ㄡˊ　ㄅㄚˊ　ㄅㄨˋ　ㄔㄨ
八宗	ㄅㄚ　ㄗㄨㄥ
七葷八素	ㄑ｜　ㄏㄨㄣ　ㄅㄚ　ㄙㄨˋ
拔地參天	ㄅㄚˊ　ㄉ｜ˋ　ㄘㄢ　ㄊ｜ㄢ
七長八短	ㄑ｜　ㄔㄤˊ　ㄅㄚ　ㄉㄨㄢˇ
七上八落	ㄑ｜　ㄕㄤˋ　ㄅㄚ　ㄌㄨㄛˋ
啞叭夢見媽	｜ㄚˇ　˙ㄅㄚ　ㄇㄥˋ　ㄐ｜ㄢˋ　ㄇㄚ
巴不得	ㄅㄚ　˙ㄅㄨ　˙ㄉㄜ
把舵	ㄅㄚˇ　ㄉㄨㄛˋ
巴巴	ㄅㄚ　ㄅㄚ
霸突	ㄅㄚˋ　ㄊㄨˊ
把戲	ㄅㄚˇ　ㄒ｜ˋ
二伯	ㄦˋ　ㄅㄚˋ
辛巴威共和國	ㄒ｜ㄣ　ㄅㄚ　ㄨㄟ　ㄍㄨㄥˋ　ㄏㄜˊ　ㄍㄨㄛˊ
拔腿就跑	ㄅㄚˊ　ㄊㄨㄟˇ　ㄐ｜ㄡˋ　ㄆㄠˇ
滿紙荒唐言，一把辛酸淚	ㄇㄢˇ　ㄓˇ　ㄏㄨㄤ　ㄊㄤˊ　｜ㄢˊ　｜　ㄅㄚˇ　ㄒ｜ㄣ　ㄙㄨㄢ　ㄌㄟˋ
棚朳	ㄆㄥˊ　ㄅㄚ
八節	ㄅㄚ　ㄐ｜ㄝˊ
跋	ㄅㄚˊ
把腳不住	ㄅㄚˇ　ㄐ｜ㄠˇ　ㄅㄨˋ　ㄓㄨˋ
把手	ㄅㄚˇ　ㄕㄡˇ
灞	ㄅㄚˋ
拔舌地獄	ㄅㄚˊ　ㄕㄜˊ　ㄉ｜ˋ　ㄩˋ
超群拔類	ㄔㄠ　ㄑㄩㄣˊ　ㄅㄚˊ　ㄌㄟˋ
話靶	ㄏㄨㄚˋ　ㄅㄚˇ
把色	ㄅㄚˇ　ㄙㄜˋ
疤瘌流星的	ㄅㄚ　˙ㄌㄚ　ㄌ｜ㄡˊ　ㄒ｜ㄥ　˙ㄉㄜ
巴不得一聲兒	ㄅㄚ　˙ㄅㄨ　˙ㄉㄜ　｜　ㄕㄥㄦ
拔去一丁	ㄅㄚˊ　ㄑㄩˋ　｜　ㄉ｜ㄥ
霸陵呵夜	ㄅㄚˋ　ㄌ｜ㄥˊ　ㄏㄜ　｜ㄝˋ
壩臺	ㄅㄚˋ　ㄊㄞˊ
巴結	ㄅㄚ　˙ㄐ｜ㄝ
拔不出腿來	ㄅㄚˊ　˙ㄅㄨ　ㄔㄨ　ㄊㄨㄟˇ　ㄌㄞˊ
巴斯德菌症	ㄅㄚ　ㄙ　ㄉㄜˊ　ㄐㄩㄣˋ　ㄓㄥˋ
八股文章	ㄅㄚ　ㄍㄨˇ　ㄨㄣˊ　ㄓㄤ
捏了一把冷汗	ㄋ｜ㄝ　˙ㄌㄜ　｜　ㄅㄚˇ　ㄌㄥˇ　ㄏㄢˋ
把把	ㄅㄚˇ　˙ㄅㄚ
前不巴村，後不著店	ㄑ｜ㄢˊ　ㄅㄨˋ　ㄅㄚ　ㄘㄨㄣ　ㄏㄡˋ　ㄅㄨˋ　ㄓㄠˊ　ㄉ｜ㄢˋ
蕎巴	ㄑ｜ㄠˊ　ㄅㄚ
七嘴八張	ㄑ｜　ㄗㄨㄟˇ　ㄅㄚ　ㄓㄤ
啞巴虧	｜ㄚˇ　˙ㄅㄚ　ㄎㄨㄟ
巴統	ㄅㄚ　ㄊㄨㄥˇ
龐巴瓦克	ㄆㄤˊ　ㄅㄚ　ㄨㄚˇ　ㄎㄜˋ
竟陵八友	ㄐ｜ㄥˋ　ㄌ｜ㄥˊ　ㄅㄚ　｜ㄡˇ
八仙花	ㄅㄚ　ㄒ｜ㄢ　ㄏㄨㄚ
八字	ㄅㄚ　ㄗˋ
拔身	ㄅㄚˊ　ㄕㄣ
八仙過海，各顯神通	ㄅㄚ　ㄒ｜ㄢ　ㄍㄨㄛˋ　ㄏㄞˇ　ㄍㄜˋ　ㄒ｜ㄢˇ　ㄕㄣˊ　ㄊㄨㄥ
七八下裡	ㄑ｜　ㄅㄚ　ㄒ｜ㄚˋ　ㄌ｜ˇ
大象口裡拔生牙	ㄉㄚˋ　ㄒ｜ㄤˋ　ㄎㄡˇ　ㄌ｜ˇ　ㄅㄚˊ　ㄕㄥ　｜ㄚˊ
挺拔	ㄊ｜ㄥˇ　ㄅㄚˊ
雜七雜八	ㄗㄚˊ　ㄑ｜　ㄗㄚˊ　ㄅㄚ
拔步床	ㄅㄚˊ　ㄅㄨˋ　ㄔㄨㄤˊ
雪霸國家公園	ㄒㄩㄝˇ　ㄅㄚˋ　ㄍㄨㄛˊ　ㄐ｜ㄚ　ㄍㄨㄥ　ㄩㄢˊ
結巴	ㄐ｜ㄝ　˙ㄅㄚ
便罷	ㄅ｜ㄢˋ　ㄅㄚˋ
拔起	ㄅㄚˊ　ㄑ｜ˇ
拔地倚天	ㄅㄚˊ　ㄉ｜ˋ　｜ˇ　ㄊ｜ㄢ
拔尤	ㄅㄚˊ　｜ㄡˊ
巴黎	ㄅㄚ　ㄌ｜ˊ
倒灶八字	ㄉㄠˇ　ㄗㄠˋ　ㄅㄚ　ㄗˋ
把脈	ㄅㄚˇ　ㄇㄞˋ
黏巴達	ㄋ｜ㄢˊ　ㄅㄚ　ㄉㄚˊ
一跳八丈	｜　ㄊ｜ㄠˋ　ㄅㄚ　ㄓㄤˋ
南面稱伯	ㄋㄢˊ　ㄇ｜ㄢˋ　ㄔㄥ　ㄅㄚˋ
大卸八塊	ㄉㄚˋ　ㄒ｜ㄝˋ　ㄅㄚ　ㄎㄨㄞˋ
八風	ㄅㄚ　ㄈㄥ
印把子	｜ㄣˋ　ㄅㄚˋ　˙ㄗ
絣扒	ㄅㄥ　ㄅㄚ
八方受敵	ㄅㄚ　ㄈㄤ　ㄕㄡˋ　ㄉ｜ˊ
合八字	ㄏㄜˊ　ㄅㄚ　ㄗˋ
霸王略	ㄅㄚˋ　ㄨㄤˊ　ㄌㄩㄝˋ
八分音符	ㄅㄚ　ㄈㄣ　｜ㄣ　ㄈㄨˊ
霸都魯	ㄅㄚˋ　ㄉㄨ　ㄌㄨˇ
八卦圖	ㄅㄚ　ㄍㄨㄚˋ　ㄊㄨˊ
七搭八搭	ㄑ｜　ㄉㄚ　ㄅㄚ　ㄉㄚ
七貧八富	ㄑ｜　ㄆ｜ㄣˊ　ㄅㄚ　ㄈㄨˋ
三災八難	ㄙㄢ　ㄗㄞ　ㄅㄚ　ㄋㄢˋ
巴庫	ㄅㄚ　ㄎㄨˋ
九烹十八火	ㄐ｜ㄡˇ　ㄆㄥ　ㄕˊ　ㄅㄚ　ㄏㄨㄛˇ
腳底板兒	ㄐ｜ㄠˇ　ㄉ｜ˇ　ㄅㄢˇㄦ　(變)ㄐ｜ㄠˇ　ㄉ｜ˇ　ㄅㄚˇㄦ
巴蛇吞象	ㄅㄚ　ㄕㄜˊ　ㄊㄨㄣ　ㄒ｜ㄤˋ
撼山拔樹	ㄏㄢˋ　ㄕㄢ　ㄅㄚˊ　ㄕㄨˋ
八抬轎	ㄅㄚ　ㄊㄞˊ　ㄐ｜ㄠˋ
巴家做活	ㄅㄚ　ㄐ｜ㄚ　ㄗㄨㄛˋ　ㄏㄨㄛˊ
拔除	ㄅㄚˊ　ㄔㄨˊ
拔跡	ㄅㄚˊ　ㄐ｜
神采英拔	ㄕㄣˊ　ㄘㄞˇ　｜ㄥ　ㄅㄚˊ
巴鹽	ㄅㄚ　｜ㄢˊ
巴波亞	ㄅㄚ　ㄅㄛ　｜ㄚˋ
八分休止符	ㄅㄚ　ㄈㄣ　ㄒ｜ㄡ　ㄓˇ　ㄈㄨˊ
槍把	ㄑ｜ㄤ　ㄅㄚˋ
拔萃出群	ㄅㄚˊ　ㄘㄨㄟˋ　ㄔㄨ　ㄑㄩㄣˊ
橫七豎八	ㄏㄥˊ　ㄑ｜　ㄕㄨˋ　ㄅㄚ
八帶魚	ㄅㄚ　ㄉㄞˋ　ㄩˊ
超塵拔俗	ㄔㄠ　ㄔㄣˊ　ㄅㄚˊ　ㄙㄨˊ
拔達嶺	ㄅㄚˊ　ㄉㄚˊ　ㄌ｜ㄥˇ
橫行霸道	ㄏㄥˊ　ㄒ｜ㄥˊ　ㄅㄚˋ　ㄉㄠˋ
選罷法	ㄒㄩㄢˇ　ㄅㄚˋ　ㄈㄚˇ
小喇叭	ㄒ｜ㄠˇ　ㄌㄚˇ　˙ㄅㄚ
八度音程	ㄅㄚ　ㄉㄨˋ　｜ㄣ　ㄔㄥˊ
把臂	ㄅㄚˇ　ㄅ｜ˋ
八顧	ㄅㄚ　ㄍㄨˋ
老八輩子	ㄌㄠˇ　ㄅㄚ　ㄅㄟˋ　˙ㄗ
千年田地八百主	ㄑ｜ㄢ　ㄋ｜ㄢˊ　ㄊ｜ㄢˊ　ㄉ｜ˋ　ㄅㄚ　ㄅㄞˇ　ㄓㄨˇ
卡巴迪	ㄎㄚˇ　ㄅㄚ　ㄉ｜ˊ
七拼八湊	ㄑ｜　ㄆ｜ㄣ　ㄅㄚ　ㄘㄡˋ
枉口拔舌	ㄨㄤˇ　ㄎㄡˇ　ㄅㄚˊ　ㄕㄜˊ
巴縣	ㄅㄚ　ㄒ｜ㄢˋ
半斤逢八兩	ㄅㄢˋ　ㄐ｜ㄣ　ㄈㄥˊ　ㄅㄚ　ㄌ｜ㄤˇ
罷課	ㄅㄚˋ　ㄎㄜˋ
扒魯	ㄅㄚ　ㄌㄨˇ
攻拔	ㄍㄨㄥ　ㄅㄚˊ
巴黎公社	ㄅㄚ　ㄌ｜ˊ　ㄍㄨㄥ　ㄕㄜˋ
把都兒	ㄅㄚˇ　ㄉㄨ　ㄦˊ
喇叭	ㄌㄚˇ　˙ㄅㄚ
春山八字	ㄔㄨㄣ　ㄕㄢ　ㄅㄚ　ㄗˋ
大巴	ㄉㄚˋ　ㄅㄚ
巴得	ㄅㄚ　ㄉㄜˊ
開拔	ㄎㄞ　ㄅㄚˊ
巴士海峽	ㄅㄚ　ㄕˋ　ㄏㄞˇ　ㄒ｜ㄚˊ
八科	ㄅㄚ　ㄎㄜ
坪壩	ㄆ｜ㄥˊ　ㄅㄚˋ
八行書	ㄅㄚ　ㄏㄤˊ　ㄕㄨ
八駿	ㄅㄚ　ㄐㄩㄣˋ
女大十八變	ㄋㄩˇ　ㄉㄚˋ　ㄕˊ　ㄅㄚ　ㄅ｜ㄢˋ
狐狸尾巴	ㄏㄨˊ　˙ㄌ｜　ㄨㄟˇ　˙ㄅㄚ
吃啞吧虧	ㄔ　｜ㄚˇ　˙ㄅㄚ　ㄎㄨㄟ
拜把子	ㄅㄞˋ　ㄅㄚˇ　˙ㄗ
鞋拔子	ㄒ｜ㄝˊ　ㄅㄚˊ　˙ㄗ
秀拔	ㄒ｜ㄡˋ　ㄅㄚˊ
不如意事常八九	ㄅㄨˋ　ㄖㄨˊ　｜ˋ　ㄕˋ　ㄔㄤˊ　ㄅㄚ　ㄐ｜ㄡˇ
拔宅上昇	ㄅㄚˊ　ㄓㄞˊ　ㄕㄤˋ　ㄕㄥ
干罷	ㄍㄢ　ㄅㄚˋ
股無胈，脛不生毛	ㄍㄨˇ　ㄨˊ　ㄅㄚˊ　ㄐ｜ㄥˋ　ㄅㄨˋ　ㄕㄥ　ㄇㄠˊ
巴芬島	ㄅㄚ　ㄈㄣ　ㄉㄠˇ
巴爾札克	ㄅㄚ　ㄦˇ　ㄓㄚˊ　ㄎㄜˋ
倒八字鬚	ㄉㄠˋ　ㄅㄚ　ㄗˋ　ㄒㄩ
力巴頭	ㄌ｜ˋ　˙ㄅㄚ　ㄊㄡˊ
魃	ㄅㄚˊ
老虎嘴裡拔牙	ㄌㄠˇ　ㄏㄨˇ　ㄗㄨㄟˇ　ㄌ｜ˇ　ㄅㄚˊ　｜ㄚˊ
跋胡疐尾	ㄅㄚˊ　ㄏㄨˊ　ㄓˋ　ㄨㄟˇ
霸王別姬	ㄅㄚˋ　ㄨㄤˊ　ㄅ｜ㄝˊ　ㄐ｜
拔河	ㄅㄚˊ　ㄏㄜˊ
七橫八縱	ㄑ｜　ㄏㄥˊ　ㄅㄚ　ㄗㄨㄥ
就此罷手	ㄐ｜ㄡˋ　ㄘˇ　ㄅㄚˋ　ㄕㄡˇ
女魃	ㄋㄩˇ　ㄅㄚˊ
歐羅巴人種	ㄡ　ㄌㄨㄛˊ　ㄅㄚ　ㄖㄣˊ　ㄓㄨㄥˇ
拔貢	ㄅㄚˊ　ㄍㄨㄥˋ
八神	ㄅㄚ　ㄕㄣˊ
巴圖爾	ㄅㄚ　ㄊㄨˊ　ㄦˇ
八股文	ㄅㄚ　ㄍㄨˇ　ㄨㄣˊ
巴鼻	ㄅㄚ　ㄅ｜ˊ
超俗拔群	ㄔㄠ　ㄙㄨˊ　ㄅㄚˊ　ㄑㄩㄣˊ
笆籬	ㄅㄚ　ㄌ｜ˊ
